border_size=1
usage=map

Gg          , Gs^Fp       , Gg          , Gg          , Wo          , Wo          , Wo          , Wo          , Wo          , Wo          , Wo          , Wo          , Wo          , Wo          , Wo          , Wo          , Wo          , Wo          , Wo          , Wo          , Wo          , Wo          , Wo          , Wo          , Wo          , Wo          , Wo          , Wo          , Wo          , Wo          , Wo          , Wo          , Wo          , Wo          , Wo          , Wo          , Wo          , Wo          , Wo          , Wo          , Wo          , Gs^Fdsz     , Gs^Fdsz     , Gs^Fdsz     , Gs^Fp       , Gs^Fp       , Gs^Fdsz     , Gs^Fdsz     , Gs^Fp       , Gs^Fp       , Gs^Fp       , Gs^Fp       
Gs^Fp       , Gs^Fp       , Gg          , Ds          , Wo          , Wo          , Wo          , Wo          , Wo          , Wo          , Wo^Cov      , Wo^Cov      , 3 Wo^Kov    , Wo^Cov      , Wo          , Wo          , Wo          , Wo          , Wo          , Wo          , Wo          , Wo          , Wo          , Wo          , Wo          , Wo          , Wo          , Wo          , Wo          , Wo          , Wo          , Wo          , Wo          , Wo          , Wot         , Wot         , Wot         , Wot         , Wot         , Wot         , Gs^Fdsz     , Gs^Fdsz     , Gs^Fdsz     , Gs^Fdsz     , Gs^Fdsz     , Gs^Fdsz     , Gs^Fdsz     , Gs^Fp       , Gs^Fdsz     , Gs^Fdsz     , Gs^Fdsz     , Gs^Fp       
Ch          , Gs^Fp       , Gg          , Ds          , Wo          , Wo          , Wo          , Wo          , Wo          , Wo          , Wo^Cov      , Wo^Cov      , Wo^Cov      , Wo^Cov      , Wo          , Wo          , Wo          , Wo          , Wo          , Wo          , Wo          , Wo          , Wo          , Wo          , Wo          , Ds          , Wo^Cov      , Wo          , Wo          , Wo          , Wot         , Wot         , Wot         , Wot         , Wwt         , Wot         , Wwt         , Wot         , Ds          , Gs^Fdsz     , Gs^Fdsz     , Gs^Fdsz     , Gg^Fdsz     , Gs^Fdsz     , Gs^Fdsz     , Gs^Fdsz     , Gs^Fdsz     , Gs^Fdsz     , Gll^Fp      , Gs^Fdsz     , Gs^Fp       , Gs^Fp       
Rrc         , Ch          , Ch          , Gg          , Wo          , Wo          , Wo          , Wo          , Wo          , Wo          , Wo          , Wo^Cov      , Wo          , Wo          , Wo          , Wo          , Wo          , Wo          , Wo          , Wo          , Wo          , Wo          , Wo          , Wo          , Ds          , Wo^Cov      , 5 Wo^Kov    , Wo^Cov      , Gll^Fp      , Wot         , Wot         , Wot         , Wwt         , Wwt         , Wwt         , Wwt         , Wwt         , Wwt         , Ds          , Gs^Fdsz     , Gs^Fdsz     , Gs^Fdsz     , Gs^Fdsz     , Gs^Fdsz     , Gs^Fdsz     , Gs^Fdsz     , Gs^Fdsz     , Gs^Fdsz     , Gs^Fdsz     , Gs^Fdsz     , Rr          , Rr          
Rr^Vhc      , Rr^Vhc      , Rrc         , Ch          , Wo          , Wo          , Wo          , Wo          , Wo          , Wo          , Wo          , Wo          , Wo          , Wo          , Wo          , Wo          , Wo          , Wo          , Wo          , Wo          , Wo          , Wo          , Wo          , Wo          , Ss          , Wo^Cov      , Wo^Cov      , Wo^Cov      , Gll^Fp      , Gll^Fp      , Gll^Fp      , Wot         , Wwt         , Wwt         , Wwt         , Wwt         , Gs^Fdsz     , Gs^Fdsz     , Ds          , Gs^Fdsz     , Gs^Fdsz     , Gs^Fdsz     , Gs^Fdsz     , Gs^Fdsz     , Gll         , Gd          , Gg          , Gg          , Rr          , Rr          , Ai          , Ai          
Rrc         , Rrc         , Rr^Vhc      , Ch          , Wo          , Wo          , Wo          , Wo          , Wo          , Wo          , Wo          , Wo          , Wo          , Wo          , Wo          , Wo          , Wo          , Wo          , Wo          , Wo          , Wo          , Wo          , Wo          , Wo          , Wot         , Ds          , Wot         , Wot         , Wwt         , Wwt         , Wwt         , Wwt         , Gg^Ve       , Wwt         , Gs^Fdsz     , Gs^Fdsz     , Gs^Fdsz     , Gs^Fdsz     , Gs^Fdsz     , Gs^Fdsz     , Ds          , Ds          , Ds          , Ds          , Gll         , Gs          , 1 Gg        , Gg          , Rr          , Ai          , Ai          , Ai          
Rrc         , Rr^Vhc      , Rrc         , Ch          , Wo          , Wo          , Wo          , Wo          , Wo          , Wo          , Wo          , Wo          , Wot         , Wo          , Wot         , Wo          , Wo          , Wo          , Wo          , Wo          , Wo          , Wo          , Wot         , Wot         , Gg          , Ss          , Wwt         , Wwt         , Gs^Fdsz     , Gll^Fp      , Gll^Fp      , Gll^Fp      , Gs^Fdsz     , Gs^Fdsz     , Gs^Fdsz     , Ds          , Gs^Fdsz     , Gs^Fdsz     , Gs^Fdsz     , Gs^Fdsz     , Gs^Fdsz     , Gs^Fdsz     , Gs^Fdsz     , Gs^Fdsz     , Gs          , Gs          , Gll         , Gll         , Gll         , Ai          , Ai          , Ai          
Rr^Vhc      , Rr^Vhc      , Rrc         , Ch          , Wo          , Wo          , Wo          , Wo          , Wo          , Wo          , Wot         , Wot         , Ds          , Wot         , Ds          , Wot         , Wot         , Wo          , Wo          , Wo          , Wo          , Wo          , Wot         , Gg          , Wwt         , Wwt         , Ds          , Gs^Fdsz     , Gs^Fdsz     , Gs^Fdsz     , Gs^Fdsz     , Gs^Fdsz     , Gs^Fdsz     , Gs^Fdsz     , Gs^Fdsz     , Gs^Fdsz     , Gs^Fdsz     , Gs^Fdsz     , Gs^Fdsz     , Gs^Fdsz     , Gs^Fdsz     , Gs^Fdsz     , Gs^Fdsz     , Gs^Fdsz     , Gs^Fdsz     , Gll         , Gs          , Gll         , Gs          , Ai          , Ai          , Ai          
Rrc         , Rrc         , Ch          , Ch          , Wo          , Wo          , Wo          , Wo          , Wo          , Wo          , Wo          , Ds          , Rp          , Ds          , Rp          , Ds          , Wo          , Wo          , Wo          , Wo          , Wot         , Wot         , Wwt         , Wwt         , Gg          , Ss          , Ss          , Gs^Fdsz     , Gs^Fdsz     , Gs^Fdsz     , Gs^Fdsz     , Gs^Fdsz     , Gll^Fp      , Gs^Fdsz     , Gs^Fdsz     , Gs^Fdsz     , Gs^Fdsz     , Gll^Fp      , Gll^Fp      , Gll^Fp      , Gll^Fp      , Gs^Fdsz     , Gs^Fdsz     , Gs^Fdsz     , Gs^Fdsz     , Hhd^Fdsz    , Rr          , Rr          , Ai          , Ai          , Ai          , Ai          
Ch          , Rrc         , Rr          , Gg          , Wot         , Wot         , Wot         , Wo          , Wot         , Wo          , Wo^Bw/r     , Wo^Bw/r     , Rb          , Rp          , Gs          , Wo^Bw\r     , Wo^Bw\r     , Wo          , Gs^Fds      , Wo          , Wot         , Wot         , Gs^Fp       , Gg          , Gs^Fp       , Gs^Fp       , Gs^Fp       , Gg^Ve       , Gs^Fdsz     , Gs^Fdsz     , Gs^Fdsz     , Gll^Fp      , Gs^Fdsz     , Gs^Fdsz     , Gs^Fdsz     , Gs^Fdsz     , Gs^Fdsz     , Gs^Fdsz     , Gs^Fdsz     , Gll^Fp      , Gll^Fp      , Gll^Fp      , Gs^Fdsz     , Gs^Fdsz     , Rr          , Ai          , Ai          , Ai          , Ai          , Ai          , Ai          , Ai          
Gg          , Gg          , Gg          , Rr          , Wo^Bsb\     , Wot         , Wot         , Wot         , Gg          , Wo^Bw/r     , Wo          , Wo          , Wo          , Rb          , Rb          , Wo          , Wo          , Wo^Bw\r     , Rr          , Rr          , Wo^Bsb\     , Gs^Fp       , Rr          , Gs^Fp       , Gs^Fp       , Gg^Vh       , Gg          , Ds          , Gs^Fdsz     , Ds^Fdsz     , Gs^Fdsz     , Gs^Fds      , Rr          , Ds          , Ds          , Ds          , Gs^Fdsz     , Gs^Fdsz     , Gs^Fdsz     , Gs^Fdsz     , Gs^Fdsz     , Gs^Fdsz     , Gs^Fdsz     , Gs^Fdsz     , Ds          , Gs^Fds      , Gs^Fds      , Ai          , Gs^Fds      , Gs^Fds      , Gs^Fds      , Gs^Fds      
Gg          , Ds          , Wo          , Wot         , Wot         , Wo^Bsb\     , Rr          , Gs^Fp       , Wo          , Wo          , Wo          , Wo          , Wo          , Ds          , Wo          , Wo          , Wo          , Wo          , Wo          , Wo          , Gs^Fp       , Rr          , Gg          , Rr          , Rr          , Rr          , Rr          , Gs^Fdsz     , Ai          , Ai          , Gs^Fdsz     , Gs^Fdsz     , Gs^Fds      , Gs^Fds      , Gs^Fds      , Gs^Fds      , Gs^Fds      , Gs^Fdsz     , Gll^Fp      , Gs^Fdsz     , Gll^Fp      , Gs^Fdsz     , Gs^Fds      , Gs^Fdsz     , Rr          , Gs^Fds      , Gs^Fds      , Gs^Fds      , Ai          , Gs^Fds      , Ai          , Ai          
Ds          , Ds          , Wo          , Wo          , Wo          , Gs^Fp       , Wo          , Wo          , Wo          , Wo          , Wo          , Wo          , Wo          , Wo          , Wo          , Wo          , Wo          , Wo          , Wot         , Wot         , Wot         , Gs^Fp       , Wot         , Gg          , Wwt         , Gg          , Gg          , Rr          , Ai          , Ai          , Gs^Fds      , Gs^Fds      , Gs^Fds      , Gs^Fds      , Gs^Fds      , Gs^Fds      , Gll^Fp      , Gll^Fp      , Gll^Fp      , Gll^Fp      , Gll^Fp      , Gs^Fds      , Gs^Fds      , Gs^Fds      , Rr          , Gs^Fds      , Gs^Fds      , Ai          , Ai          , Ai          , Ai          , Ai          
Wo          , Wo          , Wo          , Wo          , Wo          , Wo          , Wo          , Wo          , Wo          , Wo          , Wo          , Wo          , Wot         , Wot         , Wot         , Wo          , Wot         , Wot         , Wot         , Wwt         , Ss          , Wot         , Wot         , Wwt         , Wwt         , Wwt         , Wwt         , Gg          , Ai          , Ai          , Gs^Fds      , Gs^Fds      , Gs^Fds      , Gs^Fds      , Gs^Fds      , Gll^Fp      , Gs^Fds      , Gll^Fp      , Gll^Fp      , Gll^Fp      , Gs^Fds      , Gs^Fds      , Gs^Fds      , Gs^Fds      , Gs^Fds      , Gs^Fds      , Gs^Fds      , Ai          , Ai          , Ai          , Ai          , Ai          
Wo          , Wo          , Wo          , Wo          , Wo          , Wo          , Wo          , Wo          , Wo          , Wo          , Wot         , Wot         , Wot         , Wot         , Wot         , Wot         , Wot         , Wot         , Wot         , Wwt         , Wwt         , Ss          , Gs^Fp       , Wot         , Wwt         , Wwt         , Wwt         , Wwt         , Ai          , Gs^Fds      , Gs^Fds      , Gs^Fds      , Gs^Fds      , Gs^Fds      , Gs^Fds      , Gll^Fp      , Gll^Fp      , Gll^Fp      , Gs^Fds      , Gs^Fds      , Gs^Fds      , Gs^Fds      , Gs^Fds      , Gs^Fds      , Gs^Fds      , Gs^Fds      , Ai          , Ai          , Ai          , Ai          , Ai          , Ai          
Wo          , Wo          , Wo          , Wo          , Wo          , Wo          , Wot         , Wot         , Wot         , Wot         , Wot         , Wot         , Wot         , Wot         , Wot         , Wot         , Wot         , Wot         , Wwt         , Wwt         , Wwt         , Ss          , Ss          , Wwt         , Wwt         , Wwt         , Wwt         , Ai          , Ai          , Gs^Fds      , Gs^Fds      , Gs^Fds      , Gs^Fds      , Gs^Fds      , Gs^Fds      , Gs^Fds      , Gs^Fds      , Gs^Fds      , Gs^Fds      , Gs^Fds      , Gs^Fds      , Gs^Fds      , Gs^Fds      , Gs^Fds      , Rr          , Gs^Fds      , Dd^Edpp     , Dd^Esd      , Gs^Fds      , Ai          , Gs^Fds      , Gs^Fds      
Wo          , Wo          , Wo          , Wo          , Wog         , Wog         , Wot         , Wot         , Wot         , Wot         , Wot         , Wot         , Wot         , Wwt         , Wwt         , Wwt         , Wwt         , Wot         , Wwt         , Wwt         , Wwt         , Wwt         , Ss          , Gs^Fp       , Wwt         , Ss          , Ss          , Ai          , Gs^Fds      , Gs^Fds      , Gs^Fds      , Gs^Fds      , Gs^Fds      , Gs^Fds      , Gs^Fds      , Gs^Fds      , Gs^Fds      , Gs^Fds      , Gs^Fds      , Gs^Fds      , Gs^Fds      , Gs^Fds      , Gs^Fds      , Dd          , Gg^Fet      , Dd          , Gs^Cov      , Dd^Esd      , Gs^Fds      , Gs^Fds      , Gs^Fds      , Gs^Fds      
Wo          , Wo          , Wo          , Ds          , Wog         , Wog         , Wot         , Wot         , Wwt         , Wot         , Wwt         , Wot         , Wwt         , Wwt         , Wwt         , Wwt         , Wwt         , Wwt         , Wwt         , Wwt         , Wwt         , Ss          , Wwt         , Wwt         , Wwt         , Ss          , Ai          , Ai          , Gs^Fds      , Gs^Fds      , Gs^Fds      , Gs^Fds      , Gs^Fds      , Gs^Fds      , Gll^Fp      , Gs^Fds      , Gll^Fp      , Gs^Fds      , Gs^Fds      , Gll^Fp      , Gll^Fp      , Gs^Fds      , Gs^Fds      , Dd^Edpp     , Gs^Cov      , Ket         , Gs^Cov      , Dd          , Gs^Fds      , Gs^Fds      , Gs^Fds      , Gs^Fds      
Wo          , Wo          , Wo          , Ds          , Wo          , Wog         , Wot         , Wwt         , Rr          , Wwt         , Wwt         , Wwt         , Wwt         , Wwt         , Wwt         , Wwt         , Ss          , Wwt         , Wwt         , Wwt         , Ai          , Wwt         , Ai          , Ai          , Ai          , Ai          , Gs^Fds      , Gs^Fds      , Gs^Fds      , Gs^Fds      , Gs^Fds      , Gs^Fds      , Gs^Fds      , Gs^Fds      , Gll^Fp      , Gll^Fp      , Gs^Fds      , Gs^Fds      , Gs^Fds      , Gs^Fds      , Gs^Fds      , Gs^Fds      , Gs^Fds      , Dd          , Gs^Cov      , Gs^Cov      , Dd          , Dd^Edpp     , Gs^Fds      , Gs^Fds      , Gs^Fds      , Gs^Fds      
Wo          , Wo          , Ds          , Wo          , Wo          , Wo          , Ss          , Rr          , Gs          , Gs          , Wwt         , Wwt         , Wot         , Wot         , Ww^Ewl      , Wwt         , Ss          , Ss          , Ai          , Ai          , Ai          , Ai          , Gs^Fds      , Ai          , Gs^Fds      , Gs^Fds      , Gs^Fds      , Gs^Fds      , Gs^Fds      , Gs^Fds      , Gll^Fp      , Gll^Fp      , Gs^Fds      , Gs^Fds      , Gs^Fds      , Gs^Fds      , Gs^Fds      , Gs^Fds      , Gs^Fds      , Gs^Fds      , Rr          , Gs^Fds      , Gs^Fds      , Dd^Edpp     , Dd^Edp      , Dd^Edp      , Gs^Fds      , Gs^Fds      , Gs^Fds      , Gs^Fds      , Gs^Fds      , Gs^Fds      
Wo          , Wo          , Wo          , Wo          , Wo          , Wo          , Ww^Ewf      , Ss          , Ss          , Gs          , Wot         , Wot         , Ww^Ewf      , Wot         , Wot         , Wwt         , Wwt         , Ss          , Ai          , Ai          , Ai          , Gs^Fds      , Gs^Fds      , Gs^Fds      , Gs^Fds      , Gs^Fds      , Gll^Fp      , Gs^Fds      , Gll^Fp      , Gll^Fp      , Gs^Fds      , Gs^Fds      , Gs^Fds      , Gs^Fds      , Gs^Fds      , Gs^Fds      , Gs^Fds      , Gs^Fds      , Gs^Fds      , Rr          , Gs^Fds      , Gs^Fds      , Gs^Fds      , Gs^Fds      , Ai          , Ai          , Gs^Fds      , Gs^Fds      , Gs^Fds      , Gs^Fds      , Gs^Fds      , Gs^Fds      
Wo          , Wo          , Ss          , Ss          , Sm          , Wo          , Wo          , Ss          , Ss          , Ss          , Wo          , Wo          , Wo          , Wot         , Wot         , Wot         , Gs^Fp       , Ss          , Ai          , Ai          , Ai          , Gs^Fds      , Gs^Fds      , Gs^Fds      , Gll^Fp      , Gll^Fp      , Gll^Fp      , Gll^Fp      , Gll^Fp      , Gs^Fds      , Gs^Fds      , Gs^Fds      , Gs^Fds      , Gs^Fds      , Rr          , Gs^Fds      , Gs^Fds      , Gs^Fds      , Gs^Fds      , Gs^Fds      , Gs^Fds      , Gs^Fds      , Ww          , Gs^Fds      , Ai          , Ai          , Gs^Fds      , Gs^Fds      , Gs^Fds      , Gs^Fds      , Gs^Fds      , Gs^Fds      
Wo          , Wo          , Ss          , Ss          , Rr          , Sm          , Sm          , Wo          , Wo          , Wo          , Ww^Ewl      , Wo          , Gg^Fdsz     , Gg^Fdsz     , Gs^Fp       , Wwt         , Ss          , Ss          , Ai          , Ai          , Gs^Fds      , Gs^Fds      , Gs^Fds      , Gs^Fds      , Gs^Fds      , Gll^Fp      , Gs^Fds      , Gll^Fp      , Gs^Fds      , Gs^Fds      , Gll^Fp      , Gs^Fds      , Gs^Fds      , Gs^Fds      , Gs^Fds      , Rr          , Rr          , Gs^Fds      , Gs^Fds      , Gs^Fds      , Gs^Fds      , Ww          , Ai          , Ai          , Gs^Fds      , Gs^Fds      , Gs^Fds      , Gs^Fds      , Gs^Fds      , Gs^Fds      , Gs^Fds      , Gs^Fds      
Wo          , Wo          , Gg          , Gg          , Rr          , Hh^Vhh      , Hh          , Sm          , Sm          , Ww^Ewl      , Sm          , Sm          , Gg^Fdsz     , Gg^Fdsz     , Gs^Fp       , Wwt         , Ss          , Ss          , Ai          , Ai          , Ai          , Gs^Fds      , Gs^Fds      , Gs^Fds      , Gs^Fds      , Gs^Fds      , Gs^Fds      , Gs^Fds      , Gs^Fds      , Gll^Fp      , Gs^Fds      , Gs^Fds      , Gs^Fds      , Gs^Fds      , Gs^Fds      , Gs^Fds      , Gs^Fds      , Gs^Fds      , Hh          , Hh          , Ww          , Ww          , Dd          , Ai          , Gs^Fds      , Gs^Fds      , Gs^Fds      , Gs^Fds      , Gs^Fds      , Gs^Fds      , Gs^Fds      , Gs^Fds      
Wo          , Wo          , Gs^Fp       , Gs^Vh       , Rr          , Gs^Vh       , Gs^Fp       , Gs^Fp       , Gg^Fdsz     , Sm          , Gg^Fdsz     , Gg^Fdsz     , Gg^Fdsz     , Gs^Fp       , Gs^Fp       , Wwt         , Wwt         , Ss          , Ai          , Ai          , Ds          , Ai          , Ai          , Gs^Fds      , Ai          , Gs^Fds      , Gs^Fds      , Gs^Fds      , Gs^Fds      , Gll^Fp      , Gs^Fds      , Gs^Fds      , Ai          , Ai          , Ai          , Ai          , Ai          , Gs^Fds      , Mm          , Wwg         , Ww^Ewl      , Gg^Ve       , Dd          , Dd          , Gs^Fds      , Gs^Fds      , Gs^Fds      , Gll^Fp      , Gll^Fp      , Gs^Fds      , Gs^Fds      , Gs^Fds      
Wo          , Wo          , Gs^Fdsz     , Rr          , Gs^Vh       , Rr          , Rr          , Gs^Fp       , Gs^Fp       , Gg^Fdsz     , Gg^Fdsz     , Gg^Fdsz     , Gg^Fdsz     , Gs^Fp       , Ss          , Ss          , Ds          , Wwt         , Wwt         , Gg          , Gg          , Ai          , Ai          , Ai          , Rr          , Ai          , Ai          , Gs^Fds      , Gs^Fds      , Gs^Fds      , Ai          , Ai          , Ai          , Ai          , Ai          , Ai          , Ai          , Mm          , Wwg         , Ww^Ewf      , Ww^Ewf      , Hh          , Dd          , Dd          , Gs^Fds      , Gs^Fds      , Gll^Fp      , Gll^Fp      , Gll^Fp      , Gs^Fds      , Gs^Fds      , Gs^Fds      
Wo          , Wo          , Gg^Fdsz     , Gg^Fdsz     , Gg^Fdsz     , Rr^Fdsz     , Gg^Fdsz     , Rr          , Rr          , Rr          , Rr          , Gg^Fdsz     , Rr          , Rr          , Rr          , Ds          , Rr          , Rr          , Ww^Ewf      , Ww^Ewl      , Ww^Ewf      , Xu          , Xu          , Xu          , Xu          , Rr          , Rr          , Rr          , Ds          , Gg^Ve       , Rp          , Ai          , Rp          , Gd^Fetd     , Rp          , Ai          , Hh          , Wwg         , Wwg         , Wwg         , Mm          , Hh          , Dd          , Dd          , Gs^Fds      , Gs^Fds      , Gll^Fp      , Gll^Fp      , Gs^Fds      , Gs^Fds      , Gs^Fds      , Gs^Fds      
Wo          , Wo          , Gg^Fdsz     , Gg^Fdsz     , Gs^Fdsz     , Gs^Fdsz     , Gg^Fdsz     , Gg^Fdsz     , Gg^Fdsz     , Gg^Vh       , Gg          , Rr          , Ds          , Ds          , Ds          , Rr          , Xu          , Xu          , Xu          , Wwt         , Wwt         , Xu          , Xu          , Xu          , Xu          , Xu          , Xu          , Xu          , Xu          , Rp          , Rp          , Rp          , Rp          , Rp          , Rp          , Gd^Fetd     , Wwg         , Wwg         , Hh          , Mm          , Mm          , Gs^Fds      , Gs^Fds      , Gs^Fds      , Gs^Fds      , Gll^Fp      , Gll^Fp      , Gs^Fds      , Gs^Fds      , Gs^Fds      , Gs^Fds      , Gs^Fds      
Wo          , Wo          , Wo          , Gg^Fdsz     , Gs^Fdsz     , Gs^Fdsz     , Gs^Fdsz     , Gs^Fdsz     , Gs^Fdsz     , Gg^Fdsz     , Gg^Fdsz     , Ds          , Wo          , Wo          , Wo          , Ds          , Xu          , Xu          , Xu          , Wwt         , Wwt         , Xu          , Xu          , Xu          , Xu          , Xu          , Cud         , Cud         , Uh          , Ur          , Rp          , Rp          , Rp          , Rp          , Ww          , Ww          , Ai          , Ai          , Ai          , Gs^Fds      , Gs^Fds      , Gs^Fds      , Gs^Fds      , Gs^Fds      , Gs^Fds      , Gll^Fp      , Gll^Fp      , Gs^Fds      , Gs^Fds      , Gs^Fds      , Gs^Fds      , Gs^Fds      
Wo          , Wo^Cov      , Wo^Cov      , Wo          , Gs^Fdsz     , Gs^Fdsz     , Gg^Fdsz     , Gg^Fdsz     , Gg^Fdsz     , Gg^Fdsz     , Gg^Fdsz     , Ds^Fdsz     , Wo          , Wo          , Ds          , Xu          , Xu          , Xu          , Xu          , Xu          , Xu          , Wwt         , Xu          , Xu          , Uu          , 2 Kud       , Cud         , Cud         , Cud         , Ur          , Ww          , Ww          , Ww          , Ww          , Gg^Ve       , Ai          , Ai          , Ai          , Ai          , Ai          , Ai          , Gs^Fds      , Gs^Fds      , Gs^Fds      , Gs^Fds      , Gs^Fds      , Gs^Fds      , Gs^Fds      , Gs^Fds      , Gs^Fds      , Gs^Fds      , Gs^Fds      
Wo          , 4 Wo^Kov    , Wo          , Wo          , Wo          , Ds          , Gg^Fdsz     , Gg^Fdsz     , Gg^Fdsz     , Gg^Fdsz     , Gg^Fdsz     , Ds          , Wo          , Wo          , Xu          , Xu          , Xu          , Xu          , Xu          , Xu          , Xu          , Xu          , Uu          , Ww          , Ww          , Cud         , Ww          , Cud         , Ww          , Ww          , Uh          , Xu          , Xu          , Rp          , Ai          , Ai          , Ai          , Ai          , Ai          , Ai          , Ai          , Ai          , Ai          , Gs^Fds      , Gs^Fds      , Gs^Fds      , Gll^Fp      , Gll^Fp      , Gs^Fds      , Gs^Fds      , Gs^Fds      , Gs^Fds      
Wo          , Wo          , Wo          , Wo          , Wo          , Ds          , Gg^Fdsz     , Gg^Fdsz     , Gg^Fdsz     , Gg^Fdsz     , Gg^Fdsz     , Ds          , Wo          , Wo          , Xu          , Xu          , Xu          , Xu          , Xu          , Xu          , Xu          , Xu          , Uu          , Uu          , Uue         , Ww          , Ww          , Ww          , Uu          , Uh          , Uh          , Xu          , Xu          , Ai          , Ai          , Ai          , Ai          , Ai          , Ai          , Ai          , Ai          , Ai          , Ai          , Ai          , Ai          , Gs^Fds      , Gs^Fds      , Gs^Fds      , Gs^Fds      , Gs^Fds      , Gs^Fds      , Gs^Fds      
