border_size=1
usage=map

Wo          , Wo          , Wo          , Wo          , Wo          , Wo          , Wo          , Wo          , Wo          , Wo          , Wo          , Wo          , Wo          , Wo          , Ww          , Ww          , Dd          , Dd          , Dd          , Dd          , Dd          , Dd          , Gs          , Gs          , Gs          , Gs^Ft       , Dd          , Dd          , Dd          , Gs          , Hd          , Gs          , Hd          , Hd          , Hd          , Dd          , Dd          , Dd          , Dd          , Dd          , Dd          , Dd          
Wo          , Wo          , Wo^Cov      , Wo          , Wo          , Wo          , Wo          , Wo          , Ss^Vhs      , Wo          , Wo          , Wo          , Gs^Ft       , Ds          , Ww          , Ww          , Dd          , Dd          , Dd          , Dd          , Dd          , Dd          , Gs^Ft       , Gs^Ft       , Gs^Ft       , Dd          , Dd          , Dd          , Dd          , Gs^Ft       , Gs          , Gs          , Hd          , Hd          , Hd          , Gs^Ft       , Dd          , Dd          , Dd          , Dd          , Dd          , Dd          
Wo          , Wo^Cov      , 2 Khw       , Wo^Cov      , Wo          , Wo          , Wo          , Gs^Ft       , Gs^Ft       , Gs^Ft       , Wo          , Wo          , Gs^Ft       , Ds          , Ds          , Ww          , Gs^Vc       , Gs^Ft       , Hd          , Hd          , Hd          , Dd          , Gs^Ft       , Dd          , Dd          , Dd          , Dd          , Dd          , Dd          , Dd          , Gs^Ft       , Gs          , Hd          , Hd          , Hd          , Gs^Ft       , Dd          , Dd          , Dd          , Dd          , Dd          , Rd          
Wo          , Wo^Cov      , Wo^Cov      , Wo^Cov      , Wo          , Wo          , Gs^Ft       , Gs^Ft       , Gs^Ft       , Gs^Ft       , Wo          , Wo          , Ww          , Gs^Ft       , Ds          , Ww          , Hd          , Hd          , Hd          , Hd          , Hd          , Hd          , Dd          , Dd          , Dd          , Dd          , Dd          , Dd          , Dd          , Hd          , Gs          , Gs          , Gs          , Gs          , Hd          , Hd          , Gs^Ft       , Dd          , Dd          , Dd          , Rd          , Rd          
Wo          , Wo          , Wo          , Wo          , Wo          , Wo          , Gs^Ft       , Gs^Ft       , Ds          , Ds          , Wo          , Ww          , Gs^Ft       , Ww          , Ds          , Ww          , Md          , Md          , Md          , Hd          , Hd          , Hd          , Dd          , Dd          , Dd          , Dd          , Hd          , Hd          , Hd          , Dd          , Dd          , Gs          , Gs          , Gs          , Gs          , Dd^Vda      , Dd^Vda      , Dd          , Rd          , Rd          , Dd          , Dd          
Wo          , Wo          , Wo          , Wo          , Wo          , Wo          , Gs^Ft       , Gs^Ft       , Ds          , Wo          , Ww          , Gs^Ft       , Gs^Ft       , Ww          , Ww          , Ww          , Md          , Md          , Md          , Md          , Md          , Hd          , Hd          , Dd          , Dd          , Gs^Ft       , Hd          , Md          , Hd          , Hd          , Hd          , Gs          , Gs          , Gs          , Re          , Rd          , Rd          , Rd          , Dd          , Dd          , Dd          , Gs          
Wo          , Wo          , Wo          , Wo          , Wo          , Wo          , Wo          , Gs^Ft       , Ds          , Wo          , Ww          , Gs^Ft       , Gs^Vc       , Ww          , Ww          , Ww          , Ww          , Ww          , Ww          , Md          , Md          , Md          , Hd          , Gs^Ft       , Gs^Ft       , Gs^Ft       , Hd          , Hd          , Md          , Md          , Hd          , Gs          , Gs          , Re          , Gs^Ft       , Rd          , Dd          , Dd          , Dd          , Dd          , Dd          , Dd          
Wo          , Wo          , Gs^Ft       , Gs^Ft       , Gs^Ft       , Wo          , Wo          , Wo          , Ww          , Ww          , Ww          , Gs^Ft       , Ds          , Ds          , Ww          , Ww          , Ww          , Ww          , Md          , Md          , Md          , Md          , Md          , Gs^Ft       , Gs          , Gs^Ft       , Gs          , Hd          , Hd          , Hd          , Hd          , Gs          , Re          , Re          , Dd          , Gs^Ft       , Gs^Ft       , Dd          , Dd          , Dd          , Dd          , Dd          
Wo          , Wo          , Gs^Ft       , Gs^Ft       , Gs^Ft       , Ss^Vhs      , Gs^Ft       , Wo          , Ww          , Ww          , Dd          , Gs^Ft       , Gs^Ft       , Ds          , Ww          , Ww          , Ww          , Md          , Md          , Md          , Md          , Md          , Md          , Md          , Gs          , Gs^Ft       , Gs^Ft       , Gs          , Hd          , Hd          , Hd          , Gs          , Re          , Rd          , Gs^Ft       , Gs          , Gs          , Gs          , Gs^Ft       , Dd          , Dd          , Dd          
Wo          , Gs^Ft       , Gs^Ft       , Gs^Ft       , Gs^Ft       , Gs^Ft       , Gs^Ft       , Ww          , Ww          , Ww          , Dd          , Gs^Ft       , Ss          , Ss          , Ww          , Ww          , Md          , Md          , Md          , Md          , Md          , Md          , Md          , Md          , Dd          , Gs          , Gs^Ft       , Gs          , Gs          , Gs          , Gs          , Re          , Rd          , Dd          , Dd          , Gs^Ft       , Gs          , Gs          , Gs          , Gs          , Gs^Ft       , Dd          
Wo          , Gs^Ft       , Gs^Ft       , Gs^Ft       , Wo          , Wo          , Wo          , Ww          , Ww          , Ww          , Dd          , Gs^Ft       , Ss          , Sm          , Md          , Md          , Md          , Md          , Md          , Hd          , Hd          , Hd          , Gs^Ft       , Gs^Ft       , Hd          , Hd          , Gs^Ft       , Gs          , Gs          , Gs          , Gs          , Re          , Rd          , Dd          , Dd          , Dd          , Dd          , Gs          , Dd          , Ww          , Dd          , Gs^Ft       
Wo          , Wo          , Wo          , Wo          , Wo          , Wo          , Wo          , Ww          , Ww          , Dd          , Gs^Ft       , Gs^Ft       , Ss          , Sm          , Ss          , Md          , Md          , Md          , Md          , Hd          , Hd          , Hd          , Md          , Hd          , Md          , Md          , Md          , Gs^Ft       , Gs          , Gs          , Gs          , Re          , Dd          , Dd          , Dd          , Dd          , Dd          , Ww          , Ww          , Ww          , Ww          , Gs          
Wo          , Wo          , Wo          , Wo          , Wo          , Wo          , Wo          , Ww          , Dd          , Gs^Ft       , Gs^Ft       , Gs^Ft       , Ss          , Sm          , Ss          , Md          , Md          , Md          , Md          , Md          , Md          , Md          , Md          , Md          , Mv          , Md          , Md          , Md          , Dd          , Dd^Emf      , Rd          , Re          , Dd          , Dd          , Dd          , Dd          , Dd          , Ww          , Ww          , Ww          , Ww          , Ww          
Wo          , Wo          , Wo          , Wo          , Wo          , Wo          , Ww          , Dd          , Ss^Vhs      , Gs^Ft       , Gs^Ft       , Gs^Ft       , Gs^Ft       , Ss          , Gs^Ft       , Gs^Ft       , Gs^Ft       , Md          , Md          , Md          , Md          , Md          , Md          , Md          , Md          , Md          , Md          , Dd          , Rd          , Rd          , Rd          , Rd          , Hd^Edp      , Hd^Edp      , Dd^Do       , Dd          , Dd          , Dd          , Ww          , Ww          , Gs^Ft       , Dd          
Wo          , Wo          , Wo          , Wo          , Wo          , Wo          , Ww          , Dd          , Sm          , Ss          , Ss          , Ss          , Ss          , Gs^Ft       , Gs^Ft       , Gs^Ft       , Gs          , Gs          , Gs^Ft       , Gs          , Gs^Ft       , Md          , Md          , Md          , Md          , Md          , Dd          , Rd          , Dd          , Dd          , Rd          , Hd^Edp      , Hd          , Hd^Edp      , Dd          , Dd          , Dd          , Gs^Ft       , Dd          , Gs          , Dd          , Dd          
Wo          , Wo          , Wo          , Wo          , Wo          , Wo          , Ww          , Sm          , Gs^Ft       , Sm          , Sm          , Ss^Vhs      , Ss          , Gs          , Gs          , Gs          , Gs          , Gs          , Gs          , Gs          , Gs          , Gs          , Gs^Ft       , Md          , Dd          , Dd          , Rd          , Rd          , Dd          , Rd          , Hd          , Hd          , Hd          , Hd          , Dd          , Dd          , Dd          , Gs          , Gs          , Gs          , Gs^Ft       , Dd          
Wo          , Wo          , Wo          , Wo          , Wo          , Wo          , Ww          , Gs^Ft       , Sm          , Sm          , Ss          , Ss          , Ss          , Gs          , Gs          , Gs          , Gs          , Gs          , Gs          , Gs          , Gs          , Dd          , Dd          , Dd          , Rd          , Rd          , Dd          , Dd          , Rd          , Rd          , Dd          , Hd          , Hd^Edp      , Hd          , Dd          , Dd          , Dd          , Gs          , Gs          , Gs          , Gs^Ft       , Gs^Ft       
Wo          , Wo          , Wo          , Wo          , Wo          , Wo          , Ww          , Gs^Ft       , Sm          , Sm          , Ss          , Ss          , Ss          , Gs^Vc       , Gs          , Gs          , Gs          , Gs          , Gs          , Gs          , Dd          , Dd          , Rd          , Rd          , Dd          , Dd          , Rd          , Rd          , Dd          , Hd          , Dd          , Hd          , Hd^Edp      , Hd^Edp      , Dd          , Dd          , Dd          , Gs          , Gs          , Gs          , Gs          , Gs          
Wo          , Wo          , Wo          , Wo          , Wo          , Ww          , Ww          , Ss^Vhs      , Sm          , Sm          , Ss          , Ss          , Ss          , Gs          , Gs          , Gs          , Gs^Ft       , Dd          , Dd          , Dd          , Rd          , Rd          , Dd          , Dd          , Rd          , Rd          , Dd          , Gs^Ft       , Dd^Dc       , Hd          , Hd          , Hd          , Hd          , Hd          , Hd          , Dd          , Dd          , Dd          , Gs          , Gs^Ft       , Gs          , Hd          
Wo          , Wo          , Wo          , Wo          , Wo          , Ww          , Ww          , Sm          , Ss^Vhs      , Ss          , Ss          , Ss          , Gs          , Gs          , Gs          , Gs^Ft       , Dd          , Dd          , Dd          , Dd          , Rd          , Dd          , Dd          , Dd          , Rd          , Dd          , Gs^Ft       , Gs          , Dd          , Hd          , Md          , Hd          , Hd          , Hd          , Hd^Edp      , Dd          , Dd          , Dd          , Dd          , Dd          , Gs^Ft       , Gs          
Wo          , Wo          , Wo          , Wo          , Wo          , Ww          , Ww          , Dd          , Dd          , Gs^Ft       , Gs          , Gs          , Gs          , Gs          , Gs          , Gs^Ft       , Dd          , Dd^Edp      , Dd^Edp      , Dd          , Rd          , Dd^Edp      , Dd^Edp      , Rd          , Dd          , Dd          , Dd^Emf      , Gs^Ft       , Hd          , Md          , Md          , Md^Xm       , Hd          , Hd          , Hd          , Dd^Do       , Dd          , Dd          , Dd          , Dd          , Dd          , Dd          
Wo          , Wo          , Wo          , Wo          , Wo          , Ww          , Ww          , Dd          , Dd          , Gs^Ft       , Gs          , Gs          , Gs          , Gs          , Gs          , Gs^Ft       , Dd          , Dd          , Ds^Edp      , Dd          , Rd          , Dd^Edp      , Rd          , Rd          , Dd          , Dd          , Dd          , Hd^Emf      , Hd          , Md          , Md^Xm       , Md^Xm       , Md^Xm       , Hd          , Hd          , Hd^Edp      , Dd          , Dd          , Dd          , Dd          , Dd          , Dd          
Wo          , Wo          , Wo          , Wo          , Wo          , Ww          , Ww          , Dd          , Dd          , Gs          , Gs          , Gs          , Gs          , Gs          , Gs^Ft       , Gs^Ft       , Dd          , Ds          , Ds          , Dd          , Rd          , Dd^Edp      , Rd          , Ds          , Dd          , Dd          , Dd          , Hd          , Md          , Md          , Md^Xm       , Md^Xm       , Hd          , Hd          , Hd          , Dd          , Dd          , Dd          , Gs^Ft       , Gs^Ft       , Gs^Ft       , Dd          
Wo          , Wo          , Wo          , Wo          , Wo          , Ww          , Ww          , Ww          , Dd          , Gs^Ft       , Gs          , Gs          , Gs          , Dd          , Dd          , Dd          , Dd          , Dd          , Dd          , Dd          , Rd          , Rd          , Ds          , Ds^Edpp     , Dd^Dc       , Dd          , Hd          , Hd          , Md          , Md          , Md^Xm       , Md^Xm       , Md^Xm       , Hd          , Hd          , Dd          , Gs^Ft       , Gs^Ft       , Gd          , Gs^Ft       , Gs^Ft       , Gs^Ft       
Wo          , Wo          , Wo          , Wo          , Wo          , Ww          , Ww          , Ww          , Dd          , Gs^Ft       , Gs^Ft       , Dd          , Dd          , Dd          , Dd          , Dd          , Dd          , Dd          , Dd          , Dd          , Rd          , Rd          , Ds          , Ds^Edpp     , Dd^Edpp     , Dd          , Hd          , Md          , Md^Xm       , Md^Xm       , Md^Xm       , Md          , Md          , Md          , Hd          , Dd          , Gs^Ft       , Gs^Ft       , Gd          , Gd          , Gs          , Gs^Ft       
Wo          , Wo          , Wo          , Wo          , Wo          , Wo          , Ww          , Ww          , Ww          , Gs^Ft       , Ds          , Dd          , Dd^Vdt      , Dd          , Dd^Edp      , Dd          , Dd          , Dd          , Ds          , Ds          , Re          , Re          , Ds          , Dd^Edpp     , Dd          , Hd          , Md          , Md          , Md^Xm       , Md^Xm       , Md          , Md          , Md          , Md          , Dd          , Dd          , Gs^Ft       , Gs^Ft       , Gs^Ft       , Gs          , Gd          , Gs^Ft       
Wo          , Wo          , Wo          , Wo          , Wo          , Wo          , Wo          , Ww          , Ww          , Ww          , Ds          , Ds          , Dd          , Dd^Edp      , Dd^Edp      , Dd^Edp      , Dd          , Gs^Ft       , Ds          , Re          , Ds          , Re          , Re          , Ds          , Gs^Ft       , Md          , Md          , Md^Xm       , Md          , Md          , Md          , Md          , Dd          , Dd          , Dd          , Dd          , Gs          , Gs^Ft       , Gs^Ft       , Gs^Ft       , Dd          , Dd          
Wo          , Wo          , Wo          , Wo          , Wo          , Wo          , Wo          , Wo          , Ww          , Ww          , Ds          , Ds          , Dd          , Dd^Edp      , Dd          , Dd          , Dd          , Ds          , Re          , Re          , Ds          , Ds          , Re          , Ds          , Ds          , Md          , Md          , Md          , Ql          , Ql          , Dd          , Dd^Do       , Dd          , Dd          , Dd          , Dd          , Gs          , Gs          , Hd          , Gs          , Dd          , Hd          
Wo          , Wo          , Wo          , Wo          , Wo          , Wo          , Wo          , Wo          , Wo          , Ww          , Ww          , Ds          , Ds          , Dd^Vda      , Dd          , Dd          , Re          , Re          , Gs^Ft       , Ds          , Ds          , Ds^Edp      , Ds^Edp      , Re          , Ds          , Ds          , Ds          , Ds          , Qxe         , Dd          , Dd          , Dd          , Dd          , Dd          , Dd          , Dd          , Gs          , Dd^Do       , Hd          , Hd          , Gs          , Hd          
Wo          , Wo          , Wo          , Wo          , Wo          , Wo          , Wo          , Wo          , Wo          , Wo          , Wo          , Ww          , Ds          , Dd          , Dd          , Re          , Gs^Ft       , Gs^Ft       , Gs^Ft       , Gs^Ft       , Gs^Ft       , Ds          , Ds          , Re          , Ds^Edp      , Ds^Edp      , Ds          , Dd          , Ql          , Dd          , Dd          , Dd          , Gs^Ft       , Dd          , Dd          , Gs^Ft       , Hd          , Hd          , Hd          , Hd          , Dd          , Hd          
Wo          , Wo          , Wo          , Wo          , Wo          , Wo          , Wo          , Wo          , Wo          , Wo          , Wo          , Ww          , Gs          , Gs          , Gs          , Re          , Gs          , Gs^Ft       , Gs^Ft       , Gs^Ft       , Gs^Ft       , Dd          , Ds          , Re          , Ds          , Ds^Edp      , Ds          , Dd          , Qxe         , Qxe         , Dd          , Dd          , Dd          , Dd          , Hd          , Hd          , Hd          , Hd          , Dd          , Md          , Dd          , Dd          
Wo          , Wo          , Wo          , Wo          , Wo          , Wo          , Wo          , Wo          , Wo          , Wo          , Ww          , Ww          , Gs          , Gs          , Re          , Re          , Gs^Ft       , Gs^Ft       , Gs^Ft       , Gs^Ft       , Gs^Ft       , Gs^Ft       , Ds          , Re          , Ds          , Ds          , Ds          , Dd          , Wot         , Dd          , Hd          , Hd          , Dd^Do       , Hd          , Hd          , Hd          , Md          , Dd          , Dd          , Gs^Ft       , Gs^Ft       , Dd          
Wo          , Wo          , Wo          , Wo          , Wo          , Wo          , Wo          , Wo          , Wo          , Ww          , Ww          , Ds          , Re          , Re          , Ds          , Gs^Ft       , Ds          , Gs^Ft       , Gs^Ft       , Gs^Ft       , Gs^Ft       , Dd          , Ds          , Re          , Ds          , Ds          , Wot         , Wot         , Wot         , Wot         , Md          , Qxu         , Qxu         , Md          , Md          , Md          , Ww          , Ww          , Dd          , Gs^Ft       , Gs^Ft       , Gs^Ft       
Wo          , Wo          , Wo          , Wo          , Wo          , Wo          , Wo          , Wo          , Ww          , Ww          , Ww          , Cd          , Re          , Ds          , Ds          , Ds          , Ww          , Ww          , Ww          , Ds          , Gs^Ft       , Gs^Ft       , Ds          , Re          , Gs^Ft       , Gs^Ft       , Wot         , Wot         , Wot         , Wot         , Md          , Md          , Qxu         , Md          , Md          , Ww          , Ww          , Ww          , Ww          , Gs^Ft       , Dd^Vdt      , Gs^Ft       
Wo          , Wo          , Wo          , Wo          , Wo          , Wo          , Wo          , Ww          , Ww          , Ww          , Ww          , Cd          , Cd          , Cd          , Ww          , Ww^Vm       , Ww          , Ww^Vm       , Ww          , Ds          , Ds          , Gs^Ft       , Gs^Ft       , Re          , Ds          , Gs^Ft       , Gs^Ft       , Wot         , Wot         , Wot         , Wot         , Md          , Qxu         , Md          , Ww          , Ww          , Ww          , Ww          , Ww          , Dd          , Dd          , Gs^Ft       
Wo          , Wo          , Wo          , Wo          , Wo          , Wo          , Wo          , Ww          , Ww          , Ww          , Ww          , Ww          , Ww          , Ww          , Ww          , Ww          , Ww          , Ww          , Ww^Vm       , Ww          , Ww          , Gs^Ft       , Gs^Ft       , Re          , Dd          , Gs^Ft       , Gs^Ft       , Gs^Ft       , Wot         , Wot         , Md          , Md          , Qxu         , Md          , Ww          , Ww          , Ww          , Ww          , Dd          , Dd          , Dd          , Gs^Ft       
Wo          , Wo          , Wo          , Wo          , Wo          , Wo          , Wo          , Ww          , Ww          , Ww          , Ww          , Ww          , Ww          , Ww          , Cd          , Ww          , Ww          , Ww          , Ww          , Ww^Vm       , Ww          , Ds          , Re          , Re          , Dd^Eff      , Dd          , Dd          , Gs^Ft       , Md          , Md          , Md          , Md          , Md          , Qxu         , Md          , Md          , Gs^Ft       , Dd          , Dd          , Dd          , Gs^Ft       , Gs^Ft       
Wo          , Wo          , Wo          , Wo          , Wo          , Wo          , Wo          , Ww          , Ww          , Ww          , Cd          , Cd          , 1 Kd        , Cd          , Gs          , Gs          , Gs          , Ww          , Ww          , Ww          , Gs          , Re          , Gs^Vl       , Gs^Ft       , Gs^Gvs      , Dd^Eff      , Dd^Eff      , Dd^Eff      , Hd          , Md          , Md          , Md          , Md          , Hd          , Md          , Gs^Ft       , Gs^Ft       , Gs^Ft       , Gs^Ft       , Gs^Ft       , Gs^Ft       , Gs^Ft       
Wo          , Wo          , Wo          , Wo          , Wo          , Wo          , Wo          , Ww          , Ww          , Ww          , Cd          , Cd          , Gs^Ft       , Gs          , Gs^Efm      , Dd^Vda      , Dd^Vda      , Gs          , Gs^Efm      , Gs          , Gs          , Gs          , Gs^Ft       , Gs^Ft       , Dd^Gvs      , Dd^Gvs      , Dd^Eff      , Dd^Eff      , Dd          , Hd          , Hd          , Hd          , Gs          , Gs          , Hd          , Hd          , Gs^Ft       , Gs^Ft       , Gs^Ft       , Gs^Ft       , Gs^Ft       , Gs^Ft       
Wo          , Wo          , Wo          , Wo          , Wo          , Wo          , Wo          , Ww          , Ww          , Ww          , Ww          , Rd          , Re          , Gs^Ft       , Gs          , Dd^Vda      , Gs^Efm      , Dd^Vda      , Re^Vct      , Re^Vct      , Gs          , Gs          , Gs^Ft       , Gs^Ft       , Gs^Gvs      , Gs^Eff      , Gs^Eff      , Dd          , Dd          , Gs          , Gs          , Gs          , Gs          , Gs^Ft       , Dd          , Dd          , Dd          , Gs^Ft       , Gs^Ft       , Gs^Ft       , Gs^Ft       , Gs^Ft       
Wo          , Wo          , Wo          , Wo          , Wo          , Wo          , Wo          , Ww          , Ww          , Ww          , Ww          , Ds          , Gs          , Re          , Gs          , Gs          , Gs          , Re^Vct      , Gs          , Gs          , Ww          , Ww          , Ww          , Ww          , Gs^Gvs      , Gs^Gvs      , Gs^Gvs      , Gs^Eff      , Dd^Eff      , Gs^Ft       , Gs^Ft       , Gs          , Gs          , Dd          , Dd          , Dd          , Dd          , Dd          , Dd          , Gs^Ft       , Dd          , Gs^Ft       
Wo          , Wo          , Wo          , Wo          , Wo          , Wo          , Wo          , Wo          , Ww          , Ww          , Ww          , Ww          , Gs          , Re          , Rd          , Gs          , Gs          , Gs          , Gs          , Ww          , Ww          , Ww          , Ww          , Ww          , Gs^Gvs      , Gs^Gvs      , Dd          , Dd^Eff      , Gs^Ft       , Gs^Ft       , Gs^Ft       , Gs^Ft       , Gs^Ft       , Dd          , Dd          , Dd          , Dd          , Dd          , Dd          , Dd          , Dd          , Gs^Ft       
