border_size=1
usage=map

Gs          , Xu          , Xu          , Xu          , Uu^Ufi      , Wog         , Wog         , Wog         , Wog         , Wog         , Wog         , Wog         , Wog         , Wog         , Wog         , Wog         , Ur          , Xu          , Xu          , Xu          , Xu          , Xu          , Xu          , Xu          , Xu          , Xu          , Xu          , Xu          , Xu          , Xu          , Xu          , Xu          , Xu          , Uue         , Uue         , Uue         , Uue         , Uue         , Uue         , Uue         , Uue         , Uue         
Gs          , Xu          , Xu          , Xu          , Uu^Ufi      , Wwg         , Wog         , Wog         , Wog         , Wog         , Wog         , Wog         , Wog         , Wog         , Wog         , Wog         , Ur          , Xu          , Xu          , Xu          , Xu          , Xu          , Xu          , Xu          , Urb         , Xu          , Xu          , Xu          , Urb         , Xu          , Xu          , Xu          , Xu          , Uue         , Uue         , Uue         , Uue         , Uue         , Cud         , Cud         , 2 Kud       , Uue         
Gs          , Xu          , Ur          , Uu^Ufi      , Uue         , Wwg         , Wwg         , Wog         , Wog         , Wog         , Wog         , Wog         , Wog^Bw\     , Wog         , Ur          , Ur          , Xu          , Xu          , Xu          , Xu          , Xu          , Xu          , Xu          , Urb         , Xu          , Urb         , Urb         , Urb         , Xu          , Urb         , Xu          , Xu          , Xue         , Uue         , Uue         , Uue         , Uue         , Uue         , Uue         , Cud         , Cud         , Uue         
Xu          , Ur          , Ur          , Ur          , Ur          , 1 Uue       , Uue         , Wwg         , Wwg         , Wog         , Wog         , Wog         , Wwg         , Ur          , Ur          , Ur          , Xu          , Xu          , Uue^Ii      , Xu          , Uue         , Uue         , Urb         , Urb         , Xu          , Xu          , Xu          , Xu          , Xu          , Urb         , Urb         , Xu          , Uue         , Xue         , Xu          , Uue         , Uue         , Uue         , Cud         , Cud         , Xu          , Xu          
Xu          , Xu          , Xu          , Ur          , Ur          , Ur          , Ur          , Uue         , Wwg         , Wwg         , Wwg         , Wwg         , Wwg         , Ur          , Xu          , Xu          , Uue         , Uu          , Uue         , Uue         , Xu          , Uu          , Urb         , Urb         , Uu          , Xu          , Xu          , Xu          , Urb         , Urb         , Urb         , Urb         , Urb         , Xu          , Xu          , Xu          , Xu          , Uue         , Xu          , Xu          , Xu          , Xu          
Xu          , Xu          , Xu          , Xu          , Xu          , Ur          , Ur          , Ur          , Ur          , Ur          , Ur          , Wwg         , Wwg         , Wwg         , Wwg         , Xu          , Urb         , Uu          , Uue         , Uu          , Uue         , Uu          , Urb         , Urb         , Uu^Ii       , Xu          , Xu          , Xu          , Urb         , Urb         , Urb         , Urb         , Urb         , Xu          , Xu          , Xu          , Xu          , Xu          , Xu          , Xu          , Xu          , Xu          
Xu          , Xu          , Xu          , Xu          , Xu          , Xu          , Xu          , Xu          , Xu          , Xu          , Xu          , Ur          , Ur          , Wwg         , Wwg         , Wwg         , Wwg         , Urb         , Urb         , Uue         , Urb         , Urb         , Urb         , Uu^Ii       , Uu^Ii       , Xu^Ii       , Xu          , Xu          , Xu          , Urb         , Xu          , Urb         , Xu          , Xu          , Urb         , Urb         , Urb         , Xu          , Xu          , Xu          , Wo^Ii       , Xu          
Xu          , Xu          , Xu          , Xu          , Xu          , Xu          , Xu          , Xu          , Xu          , Xu          , Xu          , Xu          , Xu          , Ur          , Ur          , Wwg         , Wwg         , Wwg         , Urb         , Urb         , Urb         , Urb         , Urb         , Urb         , Urb         , Xu          , Xu          , Qxu         , Xu          , Xu          , Xu          , Xu          , Xu          , Urb         , Xu          , Xu          , Urb         , Xu          , Urb^Ii      , Urb^Ii      , Wo^Ii       , Wo          
Xu          , Xu          , Xu          , Xu          , Xu          , Xu          , Xu          , Xu          , Ur          , Ur          , Ur          , Xu          , Xu          , Xu          , Xu          , Ur          , Ur          , Ur          , Xu          , Urb         , Xu          , Urb         , Xu          , Urb         , Xu          , Xu          , Xu          , Qxu         , Xu          , Urb         , Urb         , Xu          , Xu          , Urb         , Urb         , Urb         , Xu          , Urb         , Xu          , Xu          , Wo          , Wo          
Xu          , Xu          , Uh^Fdsz     , Xu          , Xu          , Xu          , Ur          , Ur          , Ur          , Ur          , Ur          , Ur          , Xu          , Xu          , Xu          , Xu          , Xu          , Xu          , Xu          , Xu          , Xu          , Xue         , Xu          , Xu          , Xu          , Xu          , Xu          , Qxu         , Qxu^Bs/     , Urb         , Xu          , Urb         , Urb         , Xu          , Urb         , Xu          , Xu          , Xu          , Ww          , Ww          , Xu          , Xu          
Uh          , Uh^Fdsz     , Uue         , Uh^Fdsz     , Qxu         , Xu          , Ur          , Ur          , Xu          , Xu          , Xu          , Urb         , Urb         , Xu          , Xu          , Xu          , Xu          , Xu          , Xu          , Xu          , Ur          , Ur          , Xu          , Xu          , Xu          , Xu          , Ur          , Ur          , Xu          , Qxu         , Uue         , Xu          , Xu          , Urb         , Xu          , Xu          , Ww          , Ww          , Uu^Uf       , Xu          , Xu          , Xu          
Uh          , Uue         , Uh          , Uh          , Qxu         , Qxu         , Ur          , Ur          , Xu          , Xu          , Xu          , Xu          , Urb         , Urb         , Urb         , Xu          , Xu          , Xu          , Xu          , Ur          , Xu          , Xu          , Xu          , Xu          , Ur          , Ur          , Xu          , Xu          , Uue         , Qxu^Bs/     , Qxu         , Uue         , Uue         , Xu          , Ww          , Ww          , Uu^Ufi      , Uu^Uf       , Uh          , Uh          , Uh          , Xu          
Uh          , Uue^Cov     , Uue^Cov     , Uue         , Uh          , Qxu^Bs/     , Ur          , Ur          , Ur          , Xu          , Xu          , Urb         , Urb         , Urb         , Cud         , Urb         , Xu          , Xu          , Xu          , Ur          , Ur          , Xu          , Ur          , Ur          , Xu          , Xu          , Uue         , Uue         , Xue         , Xu          , Qxu         , Xu          , Ww          , Ww          , Xu          , Xu          , Xu          , Xu          , Uh          , Uh          , Uh          , Uh          
Uh          , 5 Uue^Kov   , Uh^Cov      , Uh          , Uh          , Qxu^Bs/     , Qxu         , Ur          , Ur          , Xu          , Xu          , Urb         , Urb         , Urb         , 4 Kud       , Cud         , Xu          , Xu          , Xu          , Xu          , Ur          , Xu          , Ur          , Xu          , Xu          , Xu          , Xu          , Xue         , Ur          , Ur          , Ur          , Qxu         , Qxu         , Xu          , Xu          , Xu          , Xue         , Xu          , Uh          , Uh          , Uh          , Uh          
Uh          , Uh^Cov      , Uue^Cov     , Uue^Cov     , Uue         , Qxu         , Qxu         , Ur          , Ur          , Xu          , Xu          , Urb         , Cud         , Cud         , Cud         , Cud         , Xu          , Xu          , Xu          , Xu          , Ur          , Xu          , Ur          , Xue         , Xue         , Xu          , Xu          , Ur          , Ur          , Xu          , Xu          , Xu          , Xu          , Xu          , Ur          , Xue         , Xue         , Xue         , Xue         , Uh          , Xu          , Xu          
Uh          , Uh          , Uh          , Uue         , Uh          , Qxu         , Qxu         , Ur          , Ur          , Ur          , Xu          , Xu          , Xu          , Xu          , Xu          , Xu          , Xu          , Xu          , Xu          , Xu          , Xu          , Ur          , Xu          , Xu          , Xu          , Xue         , Ur          , Ur          , Ur          , Xu          , Xu          , Xu          , Ur          , Ur          , Xu          , Xue         , Xu          , Urb         , Urb         , Xu          , Xu          , Xu          
Xu          , Uue         , Uue         , Uh          , Uh          , Qxu         , Qxu         , Qxu         , Ur          , Ur          , Uu          , Xu          , Xu          , Xu          , Xu          , Xu          , Xu          , Xu          , Xu          , Xu          , Xu          , Xu          , Xu          , Xu          , Xu          , Xu          , Xu          , Xu          , Xu          , Xu          , Xu          , Ur          , Xu          , Xu          , Xu          , Xu          , Xu          , Xu          , Xu          , Urb         , Xu          , Xu          
Xu          , Xu          , Ur^Ii       , Ur          , Xu          , Xu          , Xu          , Xu          , Xu          , Ur          , Ur          , Uu          , Ur          , Xu          , Xu          , Cud         , Cud         , 3 Kud       , Cud         , Xu          , Xu          , Gbx         , Gbx         , Gbx         , Gbx         , Xu          , Gbx         , Xu          , Xu          , Xu          , Xu          , Xu          , Xu          , Xu          , Xu          , Xu          , Ur          , Xu          , Xu          , Xu          , Xu          , Xu          
Xu          , Xu          , Ur^Ii       , Xu          , Xu          , Xu          , Xu          , Xu          , Xu          , Xu          , Xu          , Uu          , Ur          , Uu          , Urb         , Cud         , Cud         , Cud         , Urb         , Xu          , Xu          , Gbx         , Gbx         , Gbx         , Urb         , Gbx         , Urb         , Gbx         , Urb         , Xu          , Ur          , Xu          , Xu          , Xu          , Ur          , Ur          , Ur          , Ur          , Ur          , Ur          , Ur          , Ur          
Gs          , Ur^Ii       , Xu          , Xu          , Xu          , Xu          , Xu          , Xu          , Xu          , Xu          , Xu          , Xu          , Xu          , Uu          , Urb         , Urb         , Urb         , Urb         , Urb         , Urb         , Urb         , Urb         , Urb         , Urb         , Gbx         , Urb         , Gbx         , Urb         , Gbx         , Urb         , Ur          , Ur          , Ur          , Xu          , Ur          , Ur          , Xu          , Xu          , Xu          , Xu          , Xu          , Xu          
Gs          , Gs          , Xu          , Xu          , Xu          , Xu          , Xu          , Xu          , Xu          , Xu          , Xu          , Xu          , Xu          , Xu          , Urb         , Urb         , Urb         , Urb         , Urb         , Urb         , Gbx         , Gbx         , Gbx         , Gbx         , Gbx         , Gbx         , Gbx         , Gbx         , Gbx         , Xu          , Xu          , Ur          , Ur          , Ur          , Ur          , Ur          , Xu          , Xu          , Xu          , Xu          , Xu          , Xu          
Gs          , Gs          , Xu          , Xu          , Xu          , Xu          , Xu          , Xu          , Xu          , Xu          , Xu          , Xu          , Xu          , Xu          , Urb         , Urb         , Urb         , Urb         , Xu          , Xu          , Uh          , Uh          , Uh          , Uh          , Uh          , Uh          , Uh          , Uh          , Uh          , Uh          , Xu          , Xu          , Xu          , Xu          , Xu          , Xu          , Xu          , Xu          , Xu          , Xu          , Xu          , Xu          
