border_size=1
usage=map

Gll^Fp      , Gll^Fp      , Gll^Fp      , Gll^Fp      , Gll^Fp      , Gll^Fp      , Gll^Fp      , Gll^Fp      , Gll^Fp      , Gll^Fp      , Gll^Fp      , Gll^Fp      , Gll^Fp      , Gll^Fp      , Gll^Fp      , Gll^Fp      , Gll^Fp      , Re          , Re          , Gd          , Gd          , Gs          , Gs          , Gs          , Gs          , Gs          , Gs          , Gs          , Gs          , Gs          , Ss          , Ss          , Ss          , Ss          , Ss          , Ss          , Ss          , Ss          , Ss          , Ss          , Ss          , Ss          , Ss          , Gs          , Gs          , Gs          , Gs          , Gs^Fp       , Gg          , Hh          , Mm          , Mm          
Gll^Fp      , Gll^Fp      , Gll^Fp      , Gll^Fp      , Gll^Fp      , Gll^Fp      , Gll^Fp      , Gll^Fp      , Gll^Fp      , Gll^Fp      , Gll^Fp      , Gll^Fp      , Gll^Fp      , Gll^Fp      , Gll^Fp      , Gll^Fp      , Gll^Fp      , Re          , Re          , Gd          , Hh          , Hh          , Hh          , Hh          , Hh          , Gs          , Gs          , Gd          , Gd          , Gs          , Gs          , Ss          , Re          , Re          , Gs          , Ss          , Gs          , Gs          , Ss          , Ss          , Ss          , Ss          , Ss          , Ss          , Ss          , Gs          , Gs          , Gs^Fp       , Gs^Cov      , Gs^Cov      , Hh^Cov      , Mm          
Gll^Fp      , Gll^Fp      , Gll^Fp      , Gll^Fp      , Gll^Fp      , Gll^Fp      , Gll^Fp      , Gll^Fp      , Gll^Fp      , Gll^Fp      , Gll^Fp      , Gll^Fp      , Gll^Fp      , Gll^Fp      , Gll^Fp      , Gll^Fp      , Gll^Fp      , Re          , Re          , Gd          , Hh          , Mm          , Mm          , Mm          , Hh          , Gs          , Gd          , Gd          , Gd          , Gs          , Ss          , Ss          , Re          , Gs          , Gd          , Gs          , Gs          , Ss          , Ss          , Ss          , Gs          , Gs          , Re          , Ss          , Ss          , Ss          , Ss          , Gs          , Gs^Cov      , 3 Gs^Kov    , Gs^Cov      , Hh          
Gll^Fp      , Gll^Fp      , Gs          , Gs          , Gs          , Gll^Fp      , Gll^Fp      , Gs          , Gs          , Gs          , Gs          , Gs          , Gll^Fp      , Gll^Fp      , Gll^Fp      , Gll^Fp      , Gll^Fp      , Gd          , Gd          , Gd          , Hh          , Mm          , Mm          , Mm          , Ss          , Gs          , Gd          , Gd          , Gs          , Ss          , Gs          , Ss          , Re          , Gs          , Gd          , Gd          , Gd          , Gs          , Ss          , Ss          , Gd          , Gd          , Gd          , Re          , Ss          , Ss          , Ss          , Ss          , Ss          , 2 Gs^Cov    , Gs          , Hh          
Gll^Fp      , Gll^Fp      , Gs          , Gs          , Gs          , Gll^Fp      , Gs          , Gs          , Gs          , Gs          , Gs          , Gs          , Gs          , Gll^Fp      , Gll^Fp      , Gll^Fp      , Gll^Fp      , Gd          , Gd          , Gd          , Hh          , Mm          , Mm          , Mm          , Ss          , Gs          , Gs          , Gd          , Ss          , Ss          , Gs          , Ss          , Ss          , Gs          , Re          , Gd          , Ss          , Gs          , Gs          , Ss          , Gd          , Gd          , Gd          , Re          , Ss          , Ss          , Ss          , Ss          , Ss          , Ss          , Gs          , Gs          
Gll^Fp      , Gll^Fp      , Gs          , Gs          , Gs          , Gll^Fp      , Gs          , Gs          , Gs          , Gs          , Gs          , Gs          , Gs          , Gll^Fp      , Gll^Fp      , Gll^Fp      , Gll^Fp      , Gs^Fp       , Gs^Fp       , Gs^Fp       , Hh          , Hh          , Hh          , Hh          , Hh          , Ss          , Gs          , Gd          , Gs          , Ss          , Ss          , Ss          , Ss          , Ss          , Ss          , Ss          , Ss          , Gs          , Ss          , Ss          , Ss          , Gs          , Gs          , Re          , Ss          , Ss          , Ss          , Ss          , Ss          , Ss          , Ss          , Gs          
Gll^Fp      , Gll^Fp      , Gll^Fp      , Gll^Fp      , Gll^Fp      , Gll^Fp      , Gs          , Gs          , Gs          , Re          , Gs          , Gs          , Gs          , Gll^Fp      , Gll^Fp      , Gll^Fp      , Gll^Fp      , Gs^Fp       , Gs^Fp       , Gs^Fp       , Gs^Fp       , Gs^Fp       , Gs          , Gs^Fp       , Gs^Fp       , Ss          , Ss          , Gs          , Gs          , Gs          , Ss          , Ss          , Gs          , Gs          , Ss          , Ss          , Ss          , Gs          , Gs          , Gd          , Gd          , Ss          , Gs          , Gs          , Ss          , Ss          , Ss          , Ss          , Ss          , Ss          , Ss          , Gs^Fp       
Gll^Fp      , Gll^Fp      , Gll^Fp      , Gll^Fp      , Gll^Fp      , Gll^Fp      , Gs          , Gs          , Gs          , Gs          , Gs          , Gs          , Gs          , Gll^Fp      , Gll^Fp      , Gll^Fp      , Gll^Fp      , Gll^Fp      , Gs^Fp       , Gs^Fp       , Gs^Fp       , Gs^Fp       , Gs          , Gs          , Gs^Fp       , Gs^Fp       , Ss          , Ss          , Ss          , Gs          , Ss          , Ss          , Gs          , Ss          , Ss          , Ss          , Ss          , Ss          , Gd          , Gd          , Gd          , Ss          , Ss          , Gs          , Gs          , Ss          , Ss          , Ss          , Ss          , Ss          , Ss          , Ss          
Gll^Fp      , Gll^Fp      , Gll^Fp      , Gll^Fp      , Gll^Fp      , Gll^Fp      , Gs          , Gs          , Gs          , Gs          , Gs          , Gs          , Gs          , Gll^Fp      , Gll^Fp      , Gll^Fp      , Gll^Fp      , Gll^Fp      , Gll^Fp      , Gs          , Gs          , Gs          , Gs          , Gs          , Gs          , Gs^Fp       , Gll^Fp      , Gll^Fp      , Gs^Fdsz     , Ss          , Ss          , Ss          , Gd          , Gs          , Gs          , Ss          , Ss          , Ss          , Ss          , Gd          , Ss          , Ss          , Ss          , Ss          , Gs          , Gs          , Ss          , Ss          , Ss          , Ss          , Ss          , Ss          
Gll^Fp      , Gll^Fp      , Gll^Fp      , Gll^Fp      , Gll^Fp      , Gll^Fp      , Gll^Fp      , Gs          , Gs          , Gs          , Gs          , Gs          , Gll^Fp      , Gll^Fp      , Gll^Fp      , Gll^Fp      , Gll^Fp      , Gll^Fp      , Gll^Fp      , Gll^Fp      , Gll^Fp      , Gll^Fp      , Gll^Fp      , Gll^Fp      , Gll^Fp      , Gll^Fp      , Gll^Fp      , Gll^Fp      , Gs^Fdsz     , Ss          , Ss          , Ss          , Gd          , Gd          , Gd          , Re          , Ss          , Ss          , Ss          , Ss          , Re          , Gd          , Gd          , Ss          , Gs          , Gs          , Ss          , Ss          , Rb          , Re          , Re          , Ss          
Gs^Fp       , Gll^Fp      , Gll^Fp      , Gll^Fp      , Gll^Fp      , Gll^Fp      , Gll^Fp      , Gll^Fp      , Gll^Fp      , Gll^Fp      , Gll^Fp      , Gll^Fp      , Gll^Fp      , Gll^Fp      , Gll^Fp      , Gll^Fp      , Gll^Fp      , Gll^Fp      , Gll^Fp      , Gll^Fp      , Gll^Fp      , Gll^Fp      , Gll^Fp      , Gll^Fp      , Gll^Fp      , Gll^Fp      , Gll^Fp      , Gll^Fp      , Gs^Fdsz     , Ss          , Ss          , Ss          , Gs          , Gs          , Re          , Re          , Ss          , Ss          , Ss          , Ss          , Ss          , Re          , Gs          , Ss          , Gd          , Gs          , Gs          , Gs          , Rb          , Rb          , Ss          , Ss          
Gs          , Gs          , Gll^Fp      , Gll^Fp      , Gll^Fp      , Gll^Fp      , Gll^Fp      , Gll^Fp      , Gll^Fp      , Gll^Fp      , Gll^Fp      , Gll^Fp      , Gll^Fp      , Gll^Fp      , Gll^Fp      , Gll^Fp      , Gs          , Gs          , Gs          , Gll^Fp      , Gll^Fp      , Gll^Fp      , Gll^Fp      , Gll^Fp      , Gll^Fp      , Gll^Fp      , Gll^Fp      , Gll^Fp      , Ss          , Ss          , Ss          , Gs          , Ss          , Gs          , Ss          , Ss          , Ss          , Ss          , Re          , Re          , Gd          , Ss          , Gs          , Gd          , Gd          , Gd          , Rb          , Rb          , Ss          , Ss          , Ss          , Ss          
Gs          , Gs          , Gll^Fp      , Gll^Fp      , Gll^Fp      , Gll^Fp      , Gll^Fp      , Gll^Fp      , Gll^Fp      , Gll^Fp      , Gll^Fp      , Gll^Fp      , Gll^Fp      , Gll^Fp      , Gll^Fp      , Gs          , Gs          , Gs          , Gs          , Gs          , Gll^Fp      , Gll^Fp      , Gll^Fp      , Gll^Fp      , Gll^Fp      , Gll^Fp      , Ss          , Ss          , Ss          , Ss          , Gs          , Gs          , Ss          , Ss          , Ss          , Ss          , Ss          , Ss          , Re          , Gd          , Gd          , Gd          , Gs          , Gd          , Gd          , Gd          , Rb          , Gs          , Ss          , Ss          , Ss          , Ss          
Gs          , Gs          , Gll^Fp      , Gll^Fp      , Gll^Fp      , Gll^Fp      , Gll^Fp      , Gll^Fp      , Gll^Fp      , Gll^Fp      , Gll^Fp      , Gll^Fp      , Gll^Fp      , Gll^Fp      , Gs          , Gs          , Gs          , Gs          , Gs          , Gs          , Gs          , Gll^Fp      , Gll^Fp      , Gll^Fp      , Ss          , Ss          , Ss          , Ss          , Ss          , Ss          , Ss          , Ss          , Ss          , Gs^Fp       , Gs^Fp       , Gs^Fp       , Ss          , Ss          , Re          , Gd          , Gd          , Gd          , Gs          , Rb          , Rb          , Rb          , Gd          , Gs          , Ss          , Ss          , Ss          , Ss          
Gs          , Gs          , Gll^Fp      , Gll^Fp      , Gll^Fp      , Gll^Fp      , Gll^Fp      , Gll^Fp      , Gll^Fp      , Gll^Fp      , Gll^Fp      , Gll^Fp      , Gll^Fp      , Re          , Gs          , Gs          , Gs          , Gs          , Gs          , Gs          , Gs          , Gs          , Gll^Fp      , Gll^Fp      , Ss          , Ss          , Ss          , Ss          , Ss          , Ss          , Ss          , Ss          , Ss          , Gs^Fp       , Gs^Fp       , Gs^Fp       , Ss          , Ss          , Ss          , Re          , Ss          , Ss          , Ss          , Gd          , Gd          , Gd          , Ss          , Ss          , Ss          , Ss          , Ss          , Ss          
Gs          , Gs^Fp       , Gll^Fp      , Gll^Fp      , Gll^Fp      , Gll^Fp      , Gs          , Gs          , Gs^Fp       , Gs^Fp       , Gs^Fp       , Gll^Fp      , Gll^Fp      , Re          , Re          , Hh          , Mm          , Mm          , Hh          , Gs          , Gs          , Gs          , Gll^Fp      , Gll^Fp      , Gll^Fp      , Ss          , Ss          , Ss          , Ss          , Ss          , Ss          , Ss          , Ss          , Gs^Fp       , Gs^Fp       , Gs^Fp       , Gd          , Gd          , Gd          , Ss          , Ss          , Ss          , Ss          , Ss          , Ss          , Ss          , Ss          , Ss          , Ss          , Ss          , Ss          , Ss          
Gs          , Gll^Fp      , Gll^Fp      , Gll^Fp      , Gll^Fp      , Gs          , Gs          , Gs          , Gs          , Gs^Fp       , Gs          , Gs          , Gs          , Gs          , Gd          , Mm          , Mm          , Mm          , Mm          , Gs          , Gs          , Gs          , Gll^Fp      , Gll^Fp      , Gll^Fp      , Gll^Fp      , Ss          , Ss          , Gd          , Gs          , Gs          , Ss          , Ss          , Re          , Re          , Re          , Gs          , Gd          , Gd          , Gs          , Ss          , Ss          , Ss          , Ss          , Ss          , Ss          , Ss          , Ss          , Ss          , Ss          , Ss          , Ss          
Gll^Fp      , Gll^Fp      , Gll^Fp      , Gll^Fp      , Gll^Fp      , Gs          , Gs          , Gs          , Gs^Fp       , Gs          , Gs          , Gs          , Gs          , Gs          , Mm          , Mm          , Mm          , Mm          , Mm          , Gs          , Gs          , Gs          , Rp          , Gll^Fp      , Rp          , Gll^Fp      , Gll^Fp      , Gd          , Re          , Gs          , Gs          , Ss          , Gd          , Ss          , Ss          , Gs          , Gs          , Gd          , Gs          , Gs          , Ss          , Ss          , Ss          , Ss          , Ss          , Ss          , Ss          , Ss          , Ss          , Ss          , Gs          , Gs          
Gll^Fp      , Gll^Fp      , Gll^Fp      , Gll^Fp      , Gll^Fp      , Gs          , Gs          , Gs          , Hh          , Gs          , Gs          , Gs          , Gs          , Gs          , Mm          , Mm          , Mm          , Mm          , Hh          , Re          , Rp          , Rp          , Gll^Fp      , Rp          , Gll^Fp      , Rp          , Rp          , Re          , Re          , Gs          , Gs          , Gd          , Gd          , Gd          , Ss          , Gs          , Ss          , Gs          , Ss          , Ss          , Ss          , Ss          , Ss          , Ss          , Ss          , Ss          , Ss          , Ss          , 1 Gs        , Gs          , Rp          , Gs          
Gll^Fp      , Gll^Fp      , Gll^Fp      , Gll^Fp      , Gll^Fp      , Gs^Fp       , Chr         , Chr         , Rp          , Rp          , Rp          , Re          , Re          , Gs          , Hh          , Mm          , Mm          , Hh          , Rp          , Rp          , Gs          , Gll^Fp      , Gll^Fp      , Gll^Fp      , Gll^Fp      , Gll^Fp      , Gll^Fp      , Rp          , Rp          , Gs          , Gs          , Gd          , Gd          , Gd          , Ss          , Ss          , Ss          , Ss          , Gs          , Ss          , Ss          , Ss          , Ss          , Ss          , Rp          , Rp          , Rp          , Rp          , Rp          , Rp          , Ss          , Gs          
Gll^Fp      , Gll^Fp      , Gll^Fp      , Gll^Fp      , Gll^Fp      , Gs^Fp       , Chr         , Khr         , Gs          , Re          , Re          , Rp          , Rp          , Rp          , Rp          , Gs          , Rp          , Rp          , Gs          , Gs          , Gll^Fp      , Gll^Fp      , Gll^Fp      , Gll^Fp      , Gll^Fp      , Gll^Fp      , Gll^Fp      , Gll^Fp      , Gll^Fp      , Rp          , Rp          , Gs          , Ss          , Ss          , Ss          , Ss          , Rp          , Rp          , Rp          , Gs          , Gs          , Ss          , Rp          , Rp          , Gs          , Gs          , Gs          , Gs^Fp       , Gs          , Ss          , Ss          , Gs^Fp       
Ww          , Gll^Fp      , Gll^Fp      , Gll^Fp      , Gll^Fp      , Gll^Fp      , Gs          , Gs          , Gs          , Re          , Gg          , Gll^Fp      , Gll^Fp      , Gs          , Gs          , Rp          , Gs^Fp       , Gs          , Gll^Fp      , Gll^Fp      , Gll^Fp      , Gll^Fp      , Gll^Fp      , Gll^Fp      , Gll^Fp      , Gll^Fp      , Gll^Fp      , Gll^Fp      , Gll^Fp      , Ss          , Ss          , Rp          , Rp          , Rp          , Rp          , Rp          , Ss          , Ss          , Ss          , Rp          , Rp          , Rp          , Gs          , Gs          , Ss          , Ss          , Ss          , Gs          , Ss          , Ss          , Gs^Fp       , Gs^Fp       
Wo          , Ww          , Ww          , Ww          , Ww          , Gll^Fp      , Gll^Fp      , Gll^Fp      , Gll^Fp      , Gll^Fp      , Gll^Fp      , Gll^Fp      , Gll^Fp      , Gll^Fp      , Gll^Fp      , Gll^Fp      , Gll^Fp      , Gll^Fp      , Gll^Fp      , Gll^Fp      , Gll^Fp      , Gll^Fp      , Gll^Fp      , Gll^Fp      , Gll^Fp      , Gll^Fp      , Gll^Fp      , Gll^Fp      , Gll^Fp      , Ss          , Gs          , Gd^Vhr      , Gs          , Gs          , Ss          , Ss          , Ss          , Ss          , Ss          , Ss          , Ss          , Gs          , Ss          , Ss          , Gd          , Re          , Gd          , Ss          , Ss          , Gs^Fp       , Gs^Fp       , Gs^Fp       
Wo          , Wo          , Wo          , Ww          , Ww          , Gll^Fp      , Gll^Fp      , Gll^Fp      , Gll^Fp      , Gll^Fp      , Gll^Fp      , Gll^Fp      , Gll^Fp      , Gll^Fp      , Gll^Fp      , Gll^Fp      , Gll^Fp      , Gll^Fp      , Gll^Fp      , Gll^Fp      , Gll^Fp      , Gll^Fp      , Gll^Fp      , Gll^Fp      , Gll^Fp      , Gll^Fp      , Gll^Fp      , Gll^Fp      , Gs          , Gs          , Gs          , Gs          , Gs          , Ss          , Ss          , Ss          , Re          , Re          , Re          , Ss          , Ss          , Ss          , Ss          , Gd          , Gd          , Gd          , Gd          , Gd          , Ss          , Hh          , Gs^Fp       , Gs^Fp       
Wo          , Wo          , Wo          , Wo          , Wo          , Gll^Fp      , Gll^Fp      , Gll^Fp      , Ww          , Gll^Fp      , Gll^Fp      , Gll^Fp      , Gll^Fp      , Gll^Fp      , Gll^Fp      , Gll^Fp      , Gll^Fp      , Gll^Fp      , Gll^Fp      , Gll^Fp      , Gll^Fp      , Gll^Fp      , Gll^Fp      , Gll^Fp      , Gll^Fp      , Gll^Fp      , Gll^Fp      , Gll^Fp      , Gs          , Gs          , Ss          , Gs          , Gs          , Ss          , Gs          , Re          , Gd          , Gd          , Gd          , Ss          , Ss          , Ss          , Ss          , Gd          , Gd          , Gd          , Gd          , Gd          , Hh          , Ss          , Gs^Fp       , Gs^Fp       
Wo          , Wo          , Wo          , Wo          , Wo          , Wo          , Wo          , Ww          , Gll^Fp      , Ww          , Gll^Fp      , Gll^Fp      , Gll^Fp      , Gll^Fp      , Gll^Fp      , Gll^Fp      , Gll^Fp      , Gll^Fp      , Gll^Fp      , Gll^Fp      , Gll^Fp      , Gll^Fp      , Gll^Fp      , Gll^Fp      , Gll^Fp      , Gll^Fp      , Gll^Fp      , Gll^Fp      , Gs          , Gs^Fp       , Gs^Fp       , Gs^Fp       , Gs^Fp       , Gs^Fp       , Gs          , Gs          , Gd          , Gd          , Gd          , Ss          , Ss          , Ss          , Gs          , Gs          , Gs^Fp       , Gs          , Gs          , Hh          , Ss          , Ss          , Ss          , Gs^Fp       
Wo          , Wo          , Wo          , Wo          , Wo          , Wo          , Wo          , Wo          , Wo          , Ww          , Ww          , Gll^Fp      , Gll^Fp      , Gll^Fp      , Gll^Fp      , Gll^Fp      , Gll^Fp      , Gll^Fp      , Gll^Fp      , Gll^Fp      , Gll^Fp      , Gll^Fp      , Gll^Fp      , Gll^Fp      , Gll^Fp      , Gll^Fp      , Gll^Fp      , Gll^Fp      , Gs          , Gs^Fp       , Gs^Fp       , Gs^Fp       , Gs^Fp       , Gs^Fp       , Gs          , Gs          , Gs          , Gd          , Gs          , Gs          , Gs          , Gs          , Gs          , Gs          , Gs^Fp       , Gs^Fp       , Ss          , Ss          , Ss          , Ss          , Ss          , Ss          
