border_size=1
usage=map

Hh          , Hh          , Aa          , Gg          , Gg          , Gg          , Gg          , Gg          , Gg          , Gs^Fp       , Ds          , Ds          , Ds          , Ds          , Wo          , Wo          , Wo          , Wo          , Wo          , Wo          , Wo          , Gg          , Wo          , Wo          , Wo          , Gg          , Gg          , Ww          , Ww          , Ww          , Ww          , Gs^Fp       , Gs^Fp       , Gs^Fp       , Gg          , Rr          , Rr          , Gg          , Gg          , Hh          , Hh          , Hh          
Gg          , Gg          , Aa          , Gg          , Gg^Vh       , Gg          , Aa          , Gg          , Ds          , Gg          , Gs^Fp       , Ds          , Ds          , Ds          , Ds          , Wo          , Wo          , Wo          , Wo          , Wo          , Wo          , Gg          , Wo          , Wo          , Wo          , Gg          , Gg          , Gg          , Ww          , Ww          , Ww          , Gs^Fp       , Gs^Fp       , Gs^Fp       , Gs^Fp       , Gg          , Rr          , Gg          , Gg          , Hh          , Hh          , Hh          
Aa          , Aa          , Aa          , Gg          , Gg          , Gg          , Aa          , Ds          , Gg          , Gg          , Gs^Fp       , Gs^Fp       , Gs^Fp       , Gg          , Ds          , Aa          , Wo          , Wo          , Wo          , Wo          , Wo          , Wo          , Wo          , Wo          , Wo          , Gg          , Gg          , Gs^Fp       , Ww          , Gs^Fp       , Gs^Fp       , Gg          , Gs^Fp       , Gs^Fp       , Gs^Fp       , Gs^Fp       , Gg          , Rr          , Hh          , Hh          , Hh          , Hh          
Aa          , Aa          , Aa          , Aa          , Aa          , Aa          , Aa          , Gg          , Ds          , Gg          , Gs^Fp       , Ch          , Ch          , Ch          , Aa          , Aa          , Gg          , Wo          , Wo          , Wo          , Wo          , Wo          , Wo          , Wo          , Wo          , Wo          , Wo          , Wo          , Wo          , Gs^Fp       , Gs^Fp       , Gs^Fp       , Gg          , Gg          , Gs^Fp       , Gs^Fp       , Gg          , Rr          , Hh          , Hh          , Gg          , Gg          
Hh^Fp       , Aa          , Gg          , Gg          , Gg          , Aa          , Hh          , Ds          , Ds          , Ds          , Ds          , Ch          , Kh          , Ch          , Gg          , Gg          , Gg          , Wo          , Wo          , Wo          , Wo          , Wo          , Wo          , Wo          , Wo          , Wo          , Wo          , Wo          , Gg          , Gg          , Gs^Fp       , Gs^Fp       , Ss          , Ss          , Gs^Fp       , Gg          , Gg          , Rr          , Hh          , Gg          , Gg          , Gg          
Hh          , Hh^Fp       , Gg          , Gg          , Gg          , Hh^Fp       , Hh^Fp       , Hh          , Hh          , Ww          , Ch          , Ch          , Ch          , Gg          , Gg          , Gg          , Gg          , Gg          , Wo          , Wo          , Wo          , Wo          , Wo          , Wo          , Wo          , Wo          , Wo          , Gg          , Wo          , Gg          , Gg          , Gs^Fp       , Ss          , Ss          , Gs^Fp       , Gs^Fp       , Gg          , Rr          , Gg          , Gg          , Gg          , Gg          
Hh          , Hh^Fp       , Gg          , Gg^Vh       , Gg          , Hh^Fp       , Hh^Fp       , Hh          , Ww          , Ww          , Ww          , Gg          , Rr          , Gg          , Gg          , Gg          , Gg          , Gg          , Wo          , Wo          , Wo          , Wo          , Wo          , Wo          , Wo          , Wo          , Wo          , Gg          , Wo          , Gg          , Gg          , Gg          , Ss          , Ss          , Gs^Fp       , Gg          , Rr          , Rr          , Gg          , Gg          , Gg          , Gg          
Hh^Fp       , Hh          , Hh          , Aa          , Ww          , Ww          , Ww          , Hh          , Ww          , Ds          , Ww          , Gg          , Rr          , Gg          , Gg          , Gg          , Gs^Fp       , Gs^Fp       , Wo          , Wo          , Wo          , Wo          , Wo          , Wo          , Wo          , Wo          , Wo          , Wo          , Wo          , Gg          , Gg          , Gs^Fp       , Ss          , Ss          , Gs^Fp       , Gg          , Rr          , Gs          , Gg          , Gg          , Gg          , Gg          
Ww          , Hh          , Ww          , Ww          , Ai          , Hh^Fp       , Hh          , Ww          , Ww          , Ds          , Ww          , Gg          , Rr          , Gg          , Gg          , Hh          , Hh          , Hh          , Wo          , Wo          , Wo          , Wo          , Wo          , Wo          , Wo          , Wo          , Wo          , Wo          , Wo          , Gg          , Gg          , Gs^Fp       , Gd          , Ss          , Ss          , Gs^Fp       , Rr          , Gg          , Gg          , Gg          , Gs^Fp       , Gs^Fp       
Hh^Fp       , Ww          , Hh^Fp       , Hh          , Hh^Fp       , Hh^Fp       , Mm          , Hh          , Hh          , Gg^Vh       , Ww          , Gg          , Gg          , Rr          , Rr          , Hh          , Hh          , Mm          , Wo          , Wo          , Wo          , Wo          , Wo          , Wo          , Wo          , Wo          , Wo          , Wo          , Wo          , Wo          , Gg          , Gg          , Gd          , Gs^Fp       , Gs^Fp       , Gs^Fp       , 1 Rr        , Gg          , Gg          , Gs^Fp       , Gs^Fp       , Gg          
Aa          , Hh^Fp       , Mm          , Mm          , Mm          , Mm          , Mm          , Mm          , Mm          , Hh          , Ww          , Gg          , Gg          , Rr          , Rr          , Gg^Vh       , Wo          , Wo          , Wo          , Wo          , Wo          , Wo          , Wo          , Wo          , Wo          , Wo          , Wo          , Wo          , Wo          , Wo          , Wo^Cov      , Gg          , Gg          , Gg          , Gg          , Gg          , Rr          , Gg          , Gs^Fp       , Gs^Fp       , Gg          , Hh          
Hh          , Hh          , Mm          , Mm          , Mm          , Mm          , Mm          , Mm          , Mm          , Gg          , Ww          , Gg          , Ww          , Ww^Bw|      , Wo          , Wo          , Wo          , Wo          , Wo          , Wo          , Wo          , Wo          , Wo          , Wo          , Wo          , Wo          , Wo          , Wo          , Gg          , Wo^Cov      , Wo^Cov      , Gg          , Gg          , Gg          , Gg          , Gg^Vh       , Rr          , Gg^Vh       , Gs^Fp       , Hh          , Hh^Vhh      , Hh          
Ha          , Mm          , Mm          , Mm          , Mm          , Mm          , Ch          , Ch          , Ch          , Gg          , Gg          , Ww          , Gg          , Rr          , Rr          , Wo          , Wo          , Wo          , Wo          , Wo          , Wo          , Wo          , Wo          , Wo          , Wo          , Wo          , Wo          , Wo          , Gg          , Wo^Cov      , Wo^Kov      , Gg          , Gs^Vh       , Gg          , Gg          , Rr          , Gg          , Hh          , Hh^Vhh      , Hh          , Mm          , Hh          
Mm          , Mm          , Ms^Xm       , Mm          , Mm          , Ch          , Kh          , Gg          , 4 Kh        , Ch          , Gg          , Gg          , Gg          , Rr          , Gg          , Rr          , Wo^Bsb\     , Wo          , Wo          , Wo          , Wo          , Wo          , Wo          , Wo          , Wo          , Wo          , Wo          , Wo          , Wo^Cov      , Wo^Cov      , Gg          , Gg          , Gg          , Gg          , Gg          , Rr          , Gg          , Hh          , Mm          , Mm          , Mm          , Mm          
Ms^Xm       , Ms^Xm       , Chr         , Ms^Xm       , Rrc         , Ch          , Ch          , Gg          , Ch          , Ch          , Gg          , Gg          , Gg          , Rr          , Gs^Fp       , Gs^Fp       , Wo          , Wo^Bw\      , Wo^Bw\      , Wo          , Wo          , Wo          , Wo          , Wo          , Wo          , Wo          , Wo          , Wo          , Gg          , Gg          , Gg          , Gg          , Gg          , Gg          , Gg          , Rr          , Gs^Fp       , Hh          , Mm          , Mm          , Ce          , Mm          
Ms^Xm       , Chr         , Chr         , Chr         , Ms^Xm       , Mm          , Mm          , Ch          , Hh          , Hh          , Gg          , Gg          , Rr          , Rr          , Gs          , Wo          , Gs^Fp       , Wo          , Wo          , Wo^Bw\      , Wo^Bw\      , Wo          , Wo          , Wo          , Wo          , Wo          , Wo          , Gg          , Gg          , Gg          , Gg          , Gs^Vh       , Gg          , Gg          , Gg          , Rr          , Gs^Fp       , Hh          , Ce          , Ce          , 3 Kud       , Mm          
Ms^Xm       , 5 Khr       , Chr         , Chr         , Ms^Xm       , Mm          , Hh^Fp       , Hh          , Gg          , Gg          , Rr          , Rr          , Gg          , Gg          , Gs          , Wo          , Gg          , Wo          , Wo          , Wo          , Wo          , Wo^Bw\      , Wo^Bw\      , Wo          , Wo          , Wo          , Wo          , Gg          , Gg          , Gs^Fp       , Hh          , Gg          , Hh          , Gs^Vh       , Gs^Fp       , Rr          , Hh^Fp       , Gg          , Ce          , Ce          , Ce          , Mm          
Hh          , Ms^Xm       , Ms^Xm       , Ms^Xm       , Ms^Xm       , Mm          , Hh          , Gg          , Gg          , Gg          , Rr          , Rr          , Gg          , Gg          , Wo          , Wo          , Wo          , Wo          , Wo          , Wo          , Wo          , Wo          , Wo          , Wo^Bw\      , Wo^Bw\      , Wo          , Wo          , Gg          , Hh          , Hh          , Mm          , Mm          , Mm          , Hh          , Hh          , Rr          , Gg^Ve       , Hh^Fp       , Hh^Fp       , Hh^Fp       , Hh          , Gg          
Gg          , Hh^Fp       , Hh          , Ms^Xm       , Hh^Fp       , Hh^Fp       , Gg          , Gg          , Rr          , Rr          , Gg          , Gg          , Gg          , Gg          , Wo          , Wo          , Wo          , Wo          , Wo          , Wo          , Wo          , Wo          , Wo          , Wo          , Wo          , Wo^Bw\      , Wo^Bsb\     , Hh          , Hh          , Mm          , Mm          , Mm          , Mm          , Mm          , Hh          , Rr          , Hh^Fp       , Hh^Fp       , Hh^Fp       , Hh^Fp       , Hh^Fp       , Hh^Fp       
Gg          , Gg          , Gg          , Hh          , Gg          , Gg          , Gg          , Gg          , Rr          , Gs^Fp       , Gs^Fp       , Gs^Fp       , Gg          , Gg          , Wo          , Wo          , Wo          , Wo          , Wo          , Wo          , Wo          , Wo          , Wo          , Wo          , Wo          , Wo          , Wo          , Rr          , Rr          , Hh          , Rr          , Hh          , Hh          , Mm          , Hh          , Rr          , Hh^Fp       , Gg^Ve       , Hh^Fp       , Hh^Fp       , Hh^Fp       , Hh^Fp       
Gg          , Gg          , Gg          , Gg          , Gg          , Gg          , Gg          , Rr          , Gs^Fp       , Gg^Ve       , Gs^Fp       , Gs^Fp       , Gs^Fp       , Gg          , Wo          , Wo          , Wo          , Wo          , Wo          , Wo          , Wo          , Wo          , Wo          , Wo          , Wo          , Wo          , Wo          , Mm          , Mm          , Rr          , Hh          , Rr          , Rr          , Rr          , Rr          , Rr          , Rr          , Hh^Fp       , Hh^Fp       , Hh^Fp       , Gg          , Gg          
Gg          , Gg          , Gg          , Gg          , Gg          , Gg          , Gg          , Rr          , Gg          , Gs^Fp       , Gs^Fp       , Gs^Fp       , Gs^Fp       , Wo          , Wo          , Wo          , Wo          , Wo          , Wo          , Wo          , Wo          , Wo          , Wo          , Wo          , Wo          , Wo          , Wo          , Mm          , Mm          , Mm          , Mm          , Hh          , Hh          , Hh          , Hh          , Hh          , Rr          , Rr          , Rr          , Gg          , Gg          , Gg          
Gg          , Gg          , Gg          , Gg          , Gg          , Gg          , Gg          , Rr          , Gg          , Gs^Fp       , Gs^Fp       , Gs^Fp       , Gs^Fp       , Wo          , Wo          , Wo          , Wo          , Wo          , Wo          , Wo          , Wo          , Wo          , Wo          , Wo          , Wo          , Wo          , Wo          , Mm          , Mm          , Mm          , Mm          , Mm          , Mm          , Hh          , Hh          , Rr          , Hh          , Hh^Fp       , Hh          , Rr          , Rr          , Gg          
Gg          , Gg          , Gg          , Gs^Fp       , Gs^Fp       , Gg          , Gg          , Rr          , Gg          , Gg          , Gg          , Gs^Fp       , Gs^Fp       , Wo          , Wo          , Wo          , Wo          , Wo          , Wo          , Wo          , Wo          , Wo          , Wo          , Wo          , Wo          , Wo          , Wo          , Hh          , Hh          , Mm          , Mm          , Mm          , Mm          , Hh^Vhh      , Hh          , Rr          , Hh          , Hh^Fp       , Gs^Vh       , Hh          , Hh          , Rr          
Gs^Fp       , Gs^Fp       , Gg^Ve       , Gs^Fp       , Gs^Fp       , Gs^Fp       , Gg          , Rr          , Gg          , Gg          , Gg          , Gg          , Gs^Fp       , Wo          , Wo          , Wo          , Wo          , Wo          , Wo          , Wo          , Wo          , Wo          , Wo          , Wo          , Wo          , Wo          , Wo          , Wo          , Gg          , Hh          , Hh          , Hh          , Hh          , Mm          , Hh          , Rr          , Hh          , Ww          , Gs          , Ww          , Gs^Vh       , Gg          
Gs^Fp       , Gs^Fp       , Gs^Fp       , Gg          , Ss          , Ss          , Gg          , Rr          , Gg          , Gg          , Gg          , Gg          , Gg          , Gg          , Wo          , Wo          , Wo          , Wo          , Wo          , Wo          , Wo          , Wo          , Wo          , Wo          , Wo          , Wo          , Wo          , Wo          , Wo          , Gg          , Gg          , Gg          , Gg          , Hh          , Gg          , Rr          , Gs          , Ww          , Ww          , Gs          , Ww          , Ww          
Gs^Fp       , Gs^Fp       , Gs^Fp       , Ss          , Ss          , Gs^Fp       , Gs^Fp       , Rr          , Aa          , Aa          , Gg          , Gg          , Gg          , Gg          , Wo          , Wo          , Wo          , Wo          , Wo          , Wo          , Wo          , Wo          , Wo          , Wo          , Wo          , Wo          , Wo          , Wo          , Wo          , Wo          , Wo          , Gg          , Gg^Vh       , Gg          , Gg          , Rr          , Gs          , Ww          , Ww          , Ww          , Ww          , Ww          
Gs^Fp       , Gs^Fp       , Gs^Fp       , Gs^Fp       , Gs^Fp       , Gs^Fp       , Rr          , Rr          , Gg          , Aa          , Gg          , Gg          , Gg          , Gg          , Wo          , Wo          , Wo          , Wo          , Wo          , Wo          , Wo          , Wo          , Wo          , Wo          , Gg^Vh       , Wo          , Wo          , Wo          , Wo          , Wo          , Wo          , Ww          , Ww          , Ww          , Ww          , Rr          , Ww          , Ww          , Ww          , Ww          , Gg^Vh       , Gg          
Gg          , Gg          , Gg          , Gg          , Gs^Fp       , Rr          , Gs^Fp       , Gg^Vh       , Gg          , Aa          , Gg          , Gg          , Gg          , Gg          , Wo          , Wo          , Wo          , Wo          , Wo          , Wo          , Gs          , Wo          , Gg^Vh       , Gs          , Gs          , Wo          , Wo          , Wo          , Wo          , Wo          , Wo          , Ww          , Gg          , Gg          , Gg          , Ww^Bsb|     , Ww          , Ww          , Ww          , Ww          , Gg          , Gg          
Gg          , Gg^Vh       , Gg          , Ds          , Rr          , Rr          , Gg          , Gg          , Gg          , Aa          , Gg          , Gg          , Gg          , Gg          , Wo          , Wo          , Wo          , Wo          , Gg^Vh       , Hh          , Gs          , Gs          , Gs          , Gs          , Wo          , Wo          , Wo          , Wo          , Wo          , Wo          , Wo          , Rr          , Rr          , Gg          , Gg          , Rr          , Ww          , Gg          , Gg          , Gg          , Rr          , Rr          
Gg          , Gg          , Gg          , Gg          , Rr          , Ds          , Aa          , Aa          , Aa          , Aa          , Gg          , Ds          , Ds          , Wo          , Wo          , Wo          , Wo          , Wo          , Wo          , Gs          , Wo          , Gs          , Wo          , Wo          , Wo          , Wo          , Ww          , Wo          , Ww          , Ww          , Ww          , Gg          , Gg          , Rr          , Rr          , Rr          , Rr          , Gg          , Gg          , Gs^Fp       , Rr          , Gg          
Aa          , Gg          , Gg          , Gg          , Rr          , Gg          , Aa          , Aa          , Aa          , Aa          , Ds          , Ds          , Ds          , Wo          , Wo          , Wo          , Wo          , Wo          , Wo          , Wo          , Wo          , Wo          , Wo          , Wo          , Wo          , Wo          , Ww          , Ds          , Ww          , Ww          , Ww          , Gg          , Hh          , Hh          , Hh          , Hh          , Rr          , Gg          , Gg          , Rr          , Gg          , Gg          
Aa          , Gg          , Gg          , Gg          , Rr          , Gg          , Ds          , Ds          , Ds          , Ds          , Wo          , Wo          , Wo          , Wo          , Wo          , Wo          , Wo          , Wo          , Wo          , Wo          , Wo          , Wo          , Wo          , Wo          , Wo          , Wo          , Ww          , Ds          , Ww          , Ww          , Gs^Fp       , Gs^Fp       , Gs^Fp       , Hh          , Hh          , Hh          , Rr          , Gg^Vh       , Rr          , Rr          , Gg          , Gg          
Gg          , Gg          , Gg          , Gg          , Rr          , Gg          , Gg          , Gg          , Ds          , Ww          , Wo          , Wo          , Wo          , Wo          , Wo          , Wo          , Wo          , Wo          , Wo          , Wo          , Wo          , Wo          , Wo          , Wo          , Wo          , Wo          , Ww          , Ww          , Gs^Fp       , Gs^Fp       , Gs^Fp       , Gs^Fp       , Gg^Ve       , Hh          , Hh          , Hh          , Rr          , Gg          , Rr          , Gg          , Gg          , Gg          
Gg          , Gg          , Gg          , Gg          , Rr          , Ds          , Gg          , Gg          , Ds          , Ww          , Wo          , Wo          , Wo          , Ww          , Ds          , Wo          , Wo          , Wo          , Wo          , Wo          , Wo          , Wo          , Wo          , Wo          , Wo          , Wo          , Ww          , Ww          , Gs^Fp       , Gs^Fp       , Gs^Fp       , Gs^Fp       , Gs^Fp       , Gg          , Gg          , Ch          , Ch          , Ch          , Rr          , Gg          , Gg          , Gg          
Gg          , Gg          , Gs^Fp       , Gg          , Rr          , Gg          , Gg          , Ds          , Ds          , Ds          , Ww          , Ds          , Ds          , Ds          , Ds          , Wo          , Wo          , Wo          , Wo          , Wo          , Wo          , Wo          , Wo          , Wo          , Wo          , Wo          , Ds          , Ds          , Ss          , Gs^Fp       , Gs^Fp       , Gs^Fp       , Gg          , Gg          , Gg          , Ch          , 2 Kh        , Ch          , Gg          , Gg          , Gg          , Gg          
Gg          , Gs^Fp       , Gg^Ve       , Gs^Fp       , Rr          , Ds          , Aa          , Ds          , Ds          , Ds          , Ds          , Ds          , Ds          , Ds          , Gg          , Wo          , Wo          , Wo          , Wo          , Wo          , Wo          , Wo          , Wo          , Wo          , Wo          , Wo          , Gs^Fp       , Gs^Fp       , Gs^Fp       , Gs^Fp       , Gs^Fp       , Gg          , Gg          , Gg          , Ch          , Ch          , Ch          , Rr          , Gg          , Gg          , Gg          , Gg          
Gg          , Gs^Fp       , Gs^Fp       , Ds          , Rr          , Ds          , Aa          , Gg          , Ds          , Ds          , Gs^Fp       , Gg          , Gg          , Gg          , Gg          , Wo          , Wo          , Wo          , Wo          , Wo          , Wo          , Wo          , Wo          , Wo          , Wo          , Wo          , Gs^Fp       , Ss          , Gs^Fp       , Gs^Fp       , Gg          , Gg          , Gg          , Gg          , Gg          , Gg          , Rr          , Rr          , Gg          , Gd          , Gg          , Gg          
Gg          , Gg          , Gg          , Gg          , Gg          , Rr          , Rr          , Gg          , Gg          , Gg          , Gs^Fp       , Gg^Vh       , Gg          , Gg          , Gg          , Gg          , Wo          , Wo          , Wo          , Wo          , Wo          , Wo          , Wo          , Wo          , Wo          , Wo          , Gs^Fp       , Gs^Fp       , Gs^Fp       , Gs^Fp       , Gs^Fp       , Gg          , Gg          , Gg          , Rr          , Rr          , Gg          , Gg^Vh       , Gg          , Gd          , Gg          , Gg          
Gg          , Gg          , Gg          , Gg          , Gg          , Gg          , Gg          , Rr          , Rr          , Gg          , Gg          , Gg          , Gg          , Gg          , Gg          , Gg          , Wo          , Wo          , Wo          , Wo          , Wo          , Wo          , Wo          , Wo          , Wo          , Wo          , Gs^Fp       , Gs^Fp       , Gs^Fp       , Gs^Fp       , Gg          , Gg^Vh       , Rr          , Rr          , Gg          , Gg          , Gd          , Gd          , Gd          , Gg          , Gg          , Gg          
Ds          , Gg          , Gg          , Gg          , Gg          , Gg          , Gg^Vh       , Gg          , Gg          , Rr          , Rr          , Gg          , Gg          , Gg          , Gg          , Gg          , Wo          , Wo          , Wo          , Wo          , Wo          , Wo          , Wo          , Wo          , Wo          , Wo          , Gs^Fp       , Gg^Ve       , Rr          , Gg          , Rr          , Rr          , Gg          , Gg          , Gg          , Gg          , Gg          , Ds          , Gg          , Gg          , Gg          , Gg          
Ww          , Ds          , Gg          , Gg          , Gg          , Gg          , Gg          , Gs^Fp       , Gg          , Rr          , Aa          , Rr          , Rr          , Gg          , Rr          , Gg          , Wo          , Wo          , Wo          , Wo          , Wo          , Wo          , Wo          , Wo          , Wo          , Wo          , Rr          , Rr          , Gs^Fp       , Rr          , Gg          , Gg          , Gg          , Gd          , Gg          , Gg          , Ds          , Ds          , Ds          , Gg          , Gg          , Gg          
