border_size=1
usage=map

Re          , Gs          , Gs          , Gs          , Hd          , Hd          , Hd          , Hd          , Hd          , Dd          , Dd          , Dd          , Dd          , Dd          , Dd          , Dd          , Gs          , Gs          , Gs          , Gs          , Gs          , Gs          , Dd          , Dd          , Dd          , Dd          , Dd          , Dd          , Dd          , Gs          , Gs          , Gs          , Gs          , Gs          , Gs          , Gs          , Gs          , Gs          , Gs          , Re          , Gs          , Gs          , Gs^Ft       , Dd          , Dd          , Dd          , Hd          , Hd          , Hd          , Hd          , Hd          , Hd          
Gs          , Re          , Re          , Gs          , Hd          , Hd          , Hd          , Hd          , Dd          , Dd          , Dd          , Dd          , Dd          , Dd          , Dd          , Dd          , Gs          , Dd          , Dd          , Dd          , Dd          , Gs^Ft       , Dd          , Dd          , Dd          , Dd          , Dd          , Dd          , Dd          , Gs^Ft       , Gs^Ft       , Gs          , Gs          , Gs          , Gs          , Gs          , Gs          , Gs          , Gs          , Re          , Gs          , Gs          , Gs^Ft       , Dd          , Hd          , Hd          , Hd          , Hd          , Hd          , Hd          , Hd          , Hd          
Gs          , Gs          , Gs          , Re          , Hd          , Gs^Ft       , Gs          , Gs          , Dd          , Dd          , Ww          , Ww          , Dd          , Dd          , Ww          , Ww          , Ww          , Ww          , Ww          , Dd          , Dd          , Dd          , Dd          , Dd          , Gs^Ft       , Gs^Ft       , Gs^Ft       , Gs          , Gs          , Gs^Ft       , Gs          , Gs          , Gs          , Gs          , Gs          , Gs          , Gs          , Gs          , Gs          , Re          , Gs          , Gs          , Hd          , Gs          , Hd          , Hd          , Hd          , Hd          , Hd          , Hd          , Hd          , Hd          
Gs^Ft       , Gs          , Gs          , 1 Re        , Gs^Ft       , Dd          , Gs^Ft       , Gs^Ft       , Gs^Ft       , Ww          , Ww          , Ww          , Ww          , Ww          , Dd          , Ww          , Ww          , Ww          , Dd          , Dd          , Dd          , Dd          , Dd          , Dd          , Gs          , Gs          , Gs          , Gs          , Gs          , Gs          , Gs          , Gs          , Gs^Ft       , Dd          , Gs^Ft       , Gs          , Gs          , Gs          , Gs          , Re          , Gs          , Hd          , Hd          , Hd          , Hd          , Hd          , Hd          , Hd          , Hd          , Hd          , Hd          , Gs          
Ww          , Gs          , Gs          , Re          , Re          , Dd          , Dd          , Dd          , Ww          , Ww          , Gs          , Gs^Ft       , Ww          , Ww          , Dd          , Dd          , Gs^Ft       , Gs^Ft       , Dd          , Dd          , Dd          , Dd          , Dd          , Dd          , Gs          , Gs          , Gs          , Gs          , Gs          , Gs          , Gs          , Gs          , Dd          , Dd          , Dd          , Dd          , Gs          , Gs          , Re          , Re          , Hd          , Hd          , Hd          , Hd          , Hd          , Hd          , Hd          , Hd          , Hd          , Gs          , Gs          , Gs          
Ww          , Ww          , Ww          , Gs          , Ww          , Rd          , Dd          , Dd          , Ww          , Gs          , Gs          , Gs          , Gs          , Ww          , Gs          , Gs^Ft       , Gs^Ft       , Dd          , Dd          , Dd          , Dd          , Dd          , Dd          , Dd          , Gs^Ft       , Gs          , Gs          , Gs          , Gs          , Gs          , Gs          , Gs^Ft       , Dd          , Dd          , Dd          , Dd          , Dd          , Rd          , Gs          , Hd          , Hd          , Hd          , Hd          , Hd          , Hd          , Hd          , Hd          , Hd          , Gs          , Gs          , Gs          , Gs          
Gs          , Gs          , Gs          , Ww          , Ww          , Ww^Bw|      , Ww          , Ww          , Ww          , Gs^Ft       , Gs          , Gs          , Gs          , Gs          , Gs          , Gs          , Gs^Ft       , Dd          , Dd          , Dd          , Gs          , Dd          , Gs          , Gs          , Gs          , Gs          , Gs          , Gs          , Gs          , Gs          , Gs          , Gs^Ft       , Dd          , Dd^Es       , Dd          , Dd          , Dd          , Rd          , Hd          , Hd          , Hd          , Hd          , Hd          , Hd          , Hd          , Hd          , Hd          , Hd          , Gs          , Gs          , Gs          , Gs          
Gs          , Gs          , Gs          , Gs          , Gs          , Re          , Gs          , Gs          , Gs^Ft       , Gs          , Gs          , Gs          , Gs          , Gs          , Gs          , Gs          , Gs^Ft       , Gs          , Gs          , Gs          , Gs          , Gs          , Gs          , Gs^Ft       , Gs          , Gs          , Gs          , Gs          , Gs          , Gs          , Gs          , Gs^Ft       , Dd          , Dd          , Dd          , Dd^Es       , Dd          , Rd          , Rd          , Hd          , Hd          , Hd          , Hd          , Hd          , Hd          , Hd          , Hd          , Gs          , Gs          , Gs          , Gs          , Gs          
Gs          , Gs          , Gs          , Gs          , Gs          , Rd          , Rd          , Gs^Ft       , Gs          , Gs          , Gs          , Gs          , Gs          , Gs          , Gs          , Gs          , Gs^Ft       , Gs          , Dd          , Dd          , Dd          , Gs^Ft       , Gs^Ft       , Gs          , Gs          , Gs          , Gs          , Gs          , Gs          , Gs          , Gs^Ft       , Dd          , Dd          , Dd          , Dd          , Dd          , Dd          , Gs^Ft       , Rd          , Hd          , Hd          , Hd          , Hd^Dr       , Hd          , Hd          , Hd          , Hd          , Dd          , Gs^Ft       , Gs          , Gs          , Gs          
Dd          , Gs          , Gs          , Gs          , Gs          , Dd          , Dd          , Re          , Re          , Gs          , Gs          , Gs          , Gs^Ft       , Dd          , Gs^Ft       , Gs          , Dd          , Dd          , Dd^Do       , Dd^Do       , Gs          , Gs          , Gs          , Dd          , Gs^Ft       , Gs          , Gs          , Gs          , Wwr         , Gs          , Gs^Ft       , Dd          , Dd          , Dd^Es       , Dd^Dc       , Dd          , Hd          , Hd          , Hd          , Rd          , Hd          , Hd          , Hd          , Hd          , Hd          , Dd          , Dd          , Dd          , Dd          , Dd          , Gs          , Gs          
Dd          , Gs^Ft       , Gs          , Gs          , Gs          , Gs^Ft       , Gs          , Gs          , Gs          , Re          , Gs          , Gs          , Dd          , Dd          , Dd          , Dd          , Gs^Ft       , Dd          , Gs          , Gs          , Gs          , Gs          , Ww          , Ww          , Ww          , Gs^Ft       , Gs          , Gs          , Gs          , Gs          , Gs          , Gs^Ft       , Dd^Do       , Dd          , Dd          , Hd          , Hd          , Hd          , Hd          , Rd          , Rd          , Hd          , Hd          , Hd          , Gs          , Gs          , Dd          , Dd          , Dd          , Dd          , Dd          , Gs          
Dd          , Gs^Ft       , Gs^Ft       , Gs          , Gs          , Gs          , Gs          , Gs          , Gs          , Re          , Gs^Ft       , Dd          , Dd          , Dd          , Dd          , Dd          , Dd          , Gs          , Gs          , Gs          , Gs^Ft       , Gs^Ft       , Ww          , Ww          , Ww          , Dd          , Dd          , Gs          , Gs          , Gs          , Gs          , Gs          , Gs          , Gs^Ft       , Hd          , Hd          , Hd^Dr       , Hd          , Hd          , Hd          , Hd          , Rd          , Rd          , Gs          , Re          , Gs          , Dd          , Dd          , Dd          , Dd          , Dd          , Gs^Ft       
Gs          , Gs          , Gs          , Gs          , Gs          , Gs          , Gs          , Dd          , Gs          , Re          , Gs^Ft       , Gs^Ft       , Dd          , Dd^Dc       , Dd          , Dd          , Gs^Ft       , Gs          , Gs          , Gs          , Gs^Ft       , Ww          , Ww          , Gs^Ft       , Dd          , Dd          , Dd          , Gs^Ft       , Gs          , Gs          , Gs          , Gs          , Gs          , Hd          , Hd          , Hd          , Hd          , Hd          , Hd          , Hd          , Hd          , Hd          , Dd          , Rd          , Dd^Dc       , Rd          , Rd          , Dd          , Dd          , Dd          , Gs^Ft       , Gs          
Gs          , Gs          , Gs          , Dd^Vda      , Gs^Ft       , Gs          , Gs          , Gs          , Gs          , Re          , Dd          , Dd          , Dd          , Dd          , Dd          , Dd          , Dd          , Dd          , Dd          , Ww          , Ww          , Ww          , Ww          , Gs^Ft       , Gs^Ft       , Dd          , Dd^Dc       , Dd          , Dd          , Gs          , Gs          , Gs          , Hd          , Hd          , Hd          , Hd          , Hd^Dr       , Hd          , Hd          , Hd          , Hd          , Dd          , Dd          , Dd          , Dd          , Dd          , Rd          , Dd          , Dd          , Dd          , Gs^Ft       , Gs          
Gs          , Gs          , Gs          , Gs^Ft       , Dd          , Gs^Ft       , Gs^Ft       , Gs^Ft       , Gs^Ft       , Rd          , Dd          , Dd          , Dd          , Dd          , Dd          , Dd          , Gs^Ft       , Dd          , Dd          , Ww          , Ww          , Ww          , Ww          , Ww          , Gs^Ft       , Dd          , Dd          , Dd          , Dd          , Gs^Ft       , Hd          , Hd          , Hd          , Hd          , Hd          , Hd          , Hd          , Hd          , Hd          , Hd          , Hd          , Dd          , Gs^Ft       , Gs          , Gs          , Gs^Ft       , Gs^Ft       , Re          , Gs          , Gs          , Gs          , Gs          
Hd          , Gs          , Gs          , Dd          , Dd          , Dd          , Dd          , Dd          , Dd          , Rd          , Dd          , Dd          , Dd^Es       , Dd          , Dd          , Dd          , Gs^Ft       , Dd          , Ww          , Ww          , Ww          , Ww          , Ww          , Ww          , Dd          , Dd          , Dd          , Dd          , Dd          , Dd          , Hd          , Hd          , Hd          , Hd          , Hd          , Hd          , Hd          , Hd          , Hd          , Hd          , Gs          , Gs          , Gs          , Gs          , Gs          , Gs          , Gs          , Re          , Re          , Gs          , Gs          , Gs          
Hd          , Gs          , Gs          , Gs^Ft       , Dd          , Dd^Es       , Dd^Es       , Dd          , Dd          , Rd          , Dd          , Dd          , Dd^Es       , Dd^Es       , Gs^Ft       , Gs          , Gs          , Dd          , Dd          , Ww          , Ww          , Ww          , Ww          , Ww          , Dd          , Dd          , Dd          , Dd          , Dd          , Dd          , Hd          , Hd          , Hd          , Hd          , Hd          , Hd          , Hd          , Dd^Dc       , Hd          , Hd          , Gs          , Gs          , Gs          , Gs          , Gs          , Gs          , Gs          , Gs          , Gs          , Re          , Re          , Gs          
Gs          , Gs          , Gs          , Dd          , Dd          , Dd          , Dd          , Dd^Dc       , Dd          , Rd          , Rd          , Dd          , Dd          , Dd^Es       , Dd          , Dd          , Dd          , Dd          , Dd          , Ww          , Ww          , Ww          , Ww          , Ww          , Dd          , Dd          , Dd^Dc       , Dd          , Dd          , Hd^Edp      , Hd          , Hd          , Hd          , Hd          , Hd          , Hd          , Hd          , Hd          , Hd          , Dd^Do       , Gs          , Gs          , Gs          , Gs          , Ww          , Gs          , Ww          , Dd          , Gs          , Gs          , Gs          , Re          
Gs^Ft       , Gs^Ft       , Dd          , Dd          , Dd          , Dd^Es       , Dd          , Dd          , Dd          , Dd          , Rd          , Dd          , Dd          , Dd^Dr       , Dd          , Dd          , Dd          , Dd^Dc       , Dd          , Dd          , Gs^Ft       , Ww          , Dd          , Dd          , Dd          , Dd          , Dd          , Dd          , Hd          , Hd^Edp      , Hd          , Hd^Dr       , Hd          , Hd          , Hd          , Hd          , Ww          , Ww          , Ww          , Ww          , Gs          , Gs          , Ww          , Ww          , Ww          , Ww          , Ww          , Dd          , Ww          , Ww          , Gs          , Re          
Hd          , Dd          , Dd          , Dd          , Dd          , Dd          , Dd          , Gs^Ft       , Gs^Ft       , Gs^Ft       , Dd          , Rd          , Dd          , Dd          , Dd          , Dd          , Dd          , Dd          , Gs^Ft       , Gs^Ft       , Gs          , Gs^Ft       , Dd          , Dd          , Dd          , Dd          , Dd          , Hd          , Hd          , Hd          , Hd          , Hd          , Hd          , Hd          , Ww          , Hd          , Ww          , Ww          , Ww          , Ww          , Ww          , Ww          , Gs          , Gs          , Dd          , Ww          , Ww          , Ww          , Ww          , Ww          , Gs^Ft       , Gs^Ft       
Hd          , Hd          , Dd          , Dd          , Dd          , Dd          , Dd          , Gs^Ft       , Gs^Ft       , Gs          , Gs          , Re          , Gs          , Gs^Ft       , Dd          , Dd          , Dd^Dr       , Dd          , Dd          , Dd          , Gs^Ft       , Gs^Ft       , Wwr         , Gd^Vhr      , Dd          , Dd          , Dd          , Hd          , Hd^Edp      , Hd^Edp      , Hd          , Hd          , Hd          , Ww          , Ww          , Ww          , Ww          , Ww          , Ww          , Ww          , Gs          , Gs          , Gs          , Gs          , Dd          , Ww          , Ww          , Ww          , Ww          , Ww          , Ww          , Ww          
Hd          , Hd          , Hd          , Gs          , Dd          , Dd          , Dd          , Dd          , Gs^Ft       , Gs^Ft       , Gs          , Re          , Re          , Gs^Ft       , Dd          , Dd^Es       , Dd^Edpp     , Dd          , Dd          , Dd          , Dd          , Gs^Ft       , Gs^Ft       , Gs^Ft       , Dd          , Hd          , Hd          , Hd^Edp      , Hd          , Hd          , Ww          , Ww          , Ww          , Ww          , Ww          , Ww          , Ww          , Ww          , Hd          , Hd          , Gs          , Gs          , Gs          , Dd          , Dd          , Ww          , Dd          , Ww          , Ww          , Ww          , Ww          , Ww          
Hd          , Hd          , Hd          , Gs          , Dd          , Dd          , Dd          , Dd          , Dd          , Dd          , Dd          , Gs^Ft       , Re          , Gs^Ft       , Dd          , Dd^Es       , Dd^Es       , Dd          , Dd          , Dd          , Gs^Ft       , Gs^Ft       , Gs          , Gs          , Hd          , Hd          , Hd^Edpp     , Hd^Edp      , Hd^Edp      , Hd          , Hd          , Hd          , Ww          , Ww          , Ww          , Ww          , Md          , Hd          , Hd          , Hd          , Hd          , Gs^Ft       , Gs^Ft       , Dd          , Dd          , Ww          , Dd          , Dd          , Dd          , Ww          , Ww          , Ww          
Hd          , Hd          , Hd          , Hd          , Dd          , Dd          , Dd          , Dd          , Dd          , Dd          , Dd          , Dd          , Gs^Ft       , Re          , Dd          , Dd          , Dd          , Dd          , Dd^Edpp     , Dd          , Dd          , Gs^Ft       , Gs          , Dd^Do       , Hd          , Hd          , Hd^Edp      , Hd^Edp      , Hd          , Hd          , Hd          , Hd          , Ww          , Ww          , Ww          , Ww          , Ww          , Md          , Hd          , Hd          , Ww          , Hd          , Ww          , Gs^Ft       , Ww          , Ww          , Dd          , Dd          , Dd          , Dd          , Ww          , Ww          
Md          , Hd          , Hd          , Hd          , Hd          , Hd          , Hd          , Dd          , Hd          , Dd          , Dd          , Dd          , Dd          , Rd          , Dd          , Dd          , Dd^Edpp     , Dd          , Dd          , Dd          , Dd          , Gs^Ft       , Hd          , Hd          , Hd          , Hd          , Hd^Edp      , Hd          , Hd^Dr       , Hd          , Hd^Edp      , Hd          , Hd          , Hd          , Hd          , Ww          , Ww          , Ww          , Ww          , Md          , Ww          , Ww          , Gs          , Ww          , Gs          , Gs          , Gs          , Gs          , Dd          , Dd          , Ww          , Ww          
Hd          , Hd          , Hd          , Hd          , Hd          , Hd          , Hd          , Hd          , Hd          , Hd          , Dd          , Dd          , Dd          , Rd          , Dd          , Dd          , Gs^Ft       , Dd          , Dd          , Dd^Dc       , Dd          , Gs^Ft       , Hd          , Hd          , Hd          , Hd          , Hd          , Hd          , Hd          , Hd          , Hd^Edp      , Hd^Edp      , Hd          , Dd^Dc       , Hd          , Ww          , Ww          , Ww          , Ww          , Ww          , Hd          , Hd          , Hd          , Gs          , Gs          , Gs          , Gs          , Gs          , Dd          , Dd          , Ww          , Md          
Hd          , Hd          , Hd          , Hd          , Hd          , Hd          , Hd          , Hd          , Hd          , Hd          , Hd          , Dd          , Gs          , Rd          , Re          , Gs          , Gs          , Gs^Ft       , Dd          , Dd          , Dd          , Hd          , Hd          , Hd          , Hd          , Hd          , Hd          , Hd          , Hd          , Hd          , Hd          , Hd^Edpp     , Hd          , Hd          , Hd          , Ww          , Ww          , Ww          , Md          , Md          , Hd          , Hd          , Hd          , Gs          , Gs          , Gs          , Gs          , Gs          , Gs          , Gs          , Ww          , Md          
Hd          , Hd          , Hd          , Hd          , Hd          , Hd          , Hd          , Hd          , Hd          , Hd          , Hd          , Dd          , Gs          , Gs          , Gs          , Re          , Gs          , Gs          , Dd          , Dd          , Dd          , Hd          , Hd          , Hd          , Hd          , Hd^Dr       , Hd^Es       , Hd          , Hd          , Hd^Dr       , Hd          , Hd^Es       , Hd          , Hd          , Hd          , Ww          , Ww          , Ww          , Ww          , Hd^Es       , Hd^Es       , Hd          , Hd          , Gs          , Gs          , Gs          , Gs          , Gs          , Gs          , Gs          , Ww          , Md          
Hd          , Hd          , Hd          , Hd          , Hd          , Md          , Md          , Md          , Md          , Md          , Hd          , Dd          , Dd          , Gs          , Gs          , Re          , Gs          , Gs          , Gs^Ft       , Gs^Ft       , Dd          , Gs^Ft       , Hd          , Hd^Edpp     , Hd^Edpp     , Hd          , Hd          , Hd          , Hd^Edp      , Hd^Edp      , Hd          , Hd^Es       , Dd^Dc       , Hd          , Hd          , Hd          , Ww          , Ww          , Hd^Edpp     , Hd^Es       , Hd          , Hd          , Gs          , Gs^Ft       , Gs^Ft       , Gs          , Gs          , Gs          , Ww          , Ww          , Md          , Md          
Hd          , Hd          , Hd          , Hd          , Hd          , Md          , Md          , Md          , Md          , Md          , Md          , Hd          , Dd^Es       , Dd          , Gs          , Re          , Gs          , Gs          , Gs          , Gs^Ft       , Dd          , Dd          , Hd          , Hd          , Hd          , Dd^Dc       , Hd^Dr       , Hd          , Hd^Es       , Hd^Edp      , Hd^Edp      , Hd          , Hd          , Hd          , Dd^Do       , Dd^Do       , Hd^Edpp     , Hd^Edpp     , Hd          , Hd          , Hd          , Gs          , Gs          , Gs          , Gs          , Gs          , Gs          , Ww          , Md          , Md          , Gs^Ft       , Gs^Ft       
Hd          , Hd          , Hd          , Hd          , Hd          , Md          , Md          , Md          , Md          , Md          , Dd^Es       , Dd          , Dd          , Dd          , Dd          , Re          , Re          , Gs          , Wwr         , Gs^Ft       , Dd          , Dd^Es       , Hd          , Hd^Edpp     , Hd^Es       , Hd          , Hd^Es       , Hd          , Hd^Edp      , Hd^Edp      , Hd          , Hd^Es       , Hd          , Hd          , Hd          , Hd^Edpp     , Hd          , Hd          , Hd          , Gs          , Gs          , Gs          , Gs          , Gs          , Gs          , Gs          , Ww          , Ww          , Md          , Gs^Ft       , Gs^Ft       , Gs^Ft       
Hd          , Hd          , Hd          , Hd          , Hd          , Hd          , Hd          , Md          , Md          , Md          , Dd          , Dd^Do       , Dd^Do       , Dd          , Dd          , Dd          , Re          , Gs          , Gs          , Gs^Ft       , Dd          , Dd          , Hd          , Hd          , Hd          , Hd          , Hd^Edp      , Hd^Edp      , Hd^Edp      , Hd^Edp      , Hd          , Hd^Dr       , Hd          , Hd          , Hd          , Hd          , Hd          , Hd          , Gg          , Gs          , Gs          , Gs          , Gs          , Gs          , Gs          , Gs          , Ww          , Md          , Md          , Md          , Md          , Md          
Hd          , Hd          , Hd          , Hd          , Dd          , Hd          , Hd          , Hd          , Hd          , Hd          , Hd          , Dd          , Dd          , Dd          , Gs^Ft       , Gs          , Re          , Gs          , Gs          , Gs^Ft       , Dd          , Dd^Es       , Hd          , Hd          , Dd^Dc       , Hd^Edp      , Hd          , Hd^Edp      , Hd          , Hd          , Hd          , Hd          , Hd          , Hd          , Hd          , Hd          , Gg          , Gg          , Md          , Md          , Gs          , Gs          , Gs          , Gs          , Gs          , Gs          , Ww          , Md          , Md          , Md          , Md          , Md          
Hd          , Hd          , Hd          , Dd          , Dd          , Dd          , Dd          , Dd          , Dd          , Dd          , Dd          , Hd          , Dd          , Dd          , Rd          , Re          , Gs          , Gs          , Gs          , Gs          , Gs^Ft       , Dd          , Hd          , Hd          , Hd          , Hd          , Hd          , Hd          , Hd          , Hd          , Hd          , Hd          , Hd          , Hd          , Hd          , Gs          , Md          , Md          , Md          , Md          , Md          , Md          , Md          , Ww          , Ww          , Ww          , Ww          , Md          , Md          , Md          , Md          , Md          
Rd          , Hd          , Hd          , Dd          , Dd          , Dd          , Dd          , Gs          , Re          , Gs^Ft       , Rd          , Rd          , Rd          , Rd          , Gs^Ft       , Gs          , Gs          , Gs          , Gs          , Gs          , Gs          , Gs^Ft       , Gs^Ft       , Hd          , Hd          , Hd          , Hd^Dr       , Hd          , Hd          , Hd          , Gg          , Hd          , Hd          , Hd          , Gs          , Gs          , Md          , Md          , Md          , Md          , Md          , Md          , Ww          , Ww          , Md          , Ww          , Re          , Md          , Md          , Md          , Md          , Md          
Rd          , Hd          , Hd          , Dd          , Rd          , Dd          , Rd          , Rd          , Gs^Ft       , Rd          , Dd          , Dd          , Dd          , Dd          , Dd          , Gs^Ft       , Dd          , Gs          , Gs          , Gs          , Gs^Ft       , Gs          , Gg          , Hd          , Gg          , Hd          , Gs          , Hd          , Gs          , Gg          , Gs          , Gg          , Gs          , Gs          , Gs          , Md          , Md          , Md          , Md          , Md          , Md          , Md          , Ww          , Ww          , Md          , Re          , Re          , Re          , Re          , Md          , Md          , Md          
Rd          , Hd          , Dd          , Rd          , Dd          , Rd          , Dd          , Dd          , Gs^Ft       , Gs          , Gs          , Gs^Ft       , Dd          , Dd          , Dd          , Dd          , Dd          , Dd          , Gs^Ft       , Gs^Ft       , Gs          , Gs          , Gs          , Gg          , Gg          , Gs          , Gg          , Gg          , Gs          , Gs          , Gs          , Gs^Ft       , Gs^Ft       , Gs          , Gs          , Md          , Md          , Md          , Md          , Md          , Ww          , Ww          , Ww          , Ww          , Md          , Md          , Gs^Ft       , Re          , Re          , Rd          , Md          , Md          
