border_size=1
usage=map

Ww          , Ww          , Ww          , Ww          , Ww          , Ww          , Ww          , Ww          , Ww          , Ww          , Ww          , Ww          , Ww          , Ww          , Ww          , Ww          , Ww          , Ww          , Ww          , Ww          , Ww          , Ww          
Ww          , Ww          , Ww          , Ww          , Ww          , Ww          , Ww          , Ww          , Ww          , Ww          , Ww          , Ww          , Ww          , Ww          , Ww          , Ww          , Ww          , Ww          , Ww          , Ww          , Ww          , Ww          
Rp          , Ww          , Rp          , Ww          , Rr^Vd       , Ww          , Ww          , Ww          , Ww          , Ww          , Ww          , Ww          , Ww          , Ww          , Ww          , Ww          , Ww          , Ww          , Ww          , Ww          , Ww          , Ww          
Rrc         , Rr^Vd       , Rp          , Rp          , Rp          , Ww^Bw/      , Ww          , Ww          , Ww          , Ww          , Ww          , Ww          , Ww          , Ww          , Ww          , Ww          , Ww          , Ww          , Ww          , Ww          , Ww          , Ww          
Rrc         , Rrc         , Rr^Vhc      , Rrc         , Rrc         , Ww          , Ww^Bw/      , Ww          , Ww          , Ww          , Ww          , Ww          , Ww          , Ww          , Ww          , Ww          , Ww          , Ww          , Gs          , Ww          , Gs          , Ww          
Rp          , Rr^Vhc      , Rrc         , Rr^Vhc      , Rr^Vhc      , Rrc         , Ww          , Ww          , Ww          , Ww          , Ww          , Ww          , Ww          , Ww^Bw\      , Re          , Gs^Vl       , Rrc         , Gs          , Gg          , Gs          , Gg^Efm      , Gs          
Rp          , Rp          , Rr^Vhc      , Rrc         , Rrc         , Ch          , Ch          , Ww          , Ww          , Ww^Bw\      , Re          , Ww          , Re          , Gs^Vl       , Rrc         , Rrc         , Gg^Efm      , Gg          , Gg          , Gg          , Gg          , Gg          
Rrc         , Rr^Vhc      , Rr^Vhc      , Rr^Vhc      , Rrc         , Rrc         , Kh          , Ww          , Ww          , Re          , Re          , Gs^Vc       , Rrc         , Rrc         , Gg          , Gg          , Gg          , Gg          , 1 Gg        , Gg^Efm      , Rrc         , Rrc         
Rrc         , Rrc         , Rrc         , Rrc         , Ch          , Rrc         , Rrc         , Ww          , Ww          , Gg          , Rrc         , Rrc         , Gg          , Gg^Efm      , Gg          , Gg          , Rrc         , Rrc         , Rrc         , Rrc         , Gg          , Gg          
Rrc         , Rr^Vhc      , Rrc         , Ch          , Ch          , Kh          , Ww          , Ww^Bsb\     , Rrc         , Rrc         , Gg          , Rrc         , Rrc         , Rrc         , Rrc         , Rrc         , Gg          , Gg          , Gg          , Gg          , Gg          , Gg          
Rrc         , Rr^Vhc      , Rrc         , Ch          , Ch          , Ch          , Ww          , Ww          , Gg^Gvs      , Gs^Vh       , Gs^Vh       , Gg          , Gg^Gvs      , Gg^Gvs      , Gg^Gvs      , Gg^Gvs      , Gs^Vh       , Gg          , Gg          , Gg^Efm      , Gg          , Gg          
Rrc         , Rr^Vhc      , Rrc         , Rrc         , Rrc         , Rp          , Ww          , Ww          , Gg          , Gs^Vh       , Gg          , Gg^Gvs      , Gg          , Gg^Gvs      , Gg          , Gg^Gvs      , Gg          , Gg          , Gg          , Gg          , Gg          , Gg          
