border_size=1
usage=map

Re          , Rr          , Cd          , Rr          , Gg^Fet      , Rr          , Cd          , Cd          , Cd          , Rr          , Rr          , Rr          , Cha         , Mm          , Mm          , Mm^Xm       , Mm^Xm       , Mm^Xm       , Mm          , Mm          , Gs^Fms      , Gs^Fms      , Gg          , Gg          , Gg          , Gg          , Gg^Gvs      , Gg^Gvs      , Gs^Fms      , Gg^Gvs      , Gg^Gvs      , Gg^Gvs      , Gg^Gvs      , Gg          , Gg          , Gg          , Gs^Fms      , Ww          , Ww          , Wo          , Wo          , Wo          , Re          , Gd          , Gd          , Gd          
Rp          , Cd          , Cd          , Cd          , Cd          , Cd          , Gs^Fms      , Gs^Fms      , 2 Kd        , Cd          , Rr          , Rr          , Cha         , Mm          , Mm^Xm       , Mm^Xm       , Mm^Xm       , Mm^Xm       , Mm          , Mm          , Gg          , Gs          , Gg          , Gs^Fms      , Rp          , Gg^Gvs      , Gg^Gvs      , Gg^Gvs      , Gs^Fms      , Gg^Gvs      , Gg^Gvs      , Gg^Gvs      , Gg^Gvs      , Gg^Gvs      , Gg^Gvs      , Gs^Fms      , Gs^Fms      , Ww          , Ww          , Wo          , Wo          , Wo          , Re          , Gd          , Gd          , Gd          
Mm          , Rr          , Rp          , Gg^Fet      , Cd          , Cd          , Cd          , Gs^Fms      , Cd          , 1 Cd        , Rp          , Rr          , Cha         , Mm          , Mm^Xm       , Mm^Xm       , Mm^Xm       , Mm^Xm       , Mm          , Mm          , Rrc         , Gg          , Gg^Gvs      , Gg^Gvs      , Gg^Gvs      , Rp          , Rp          , Gg^Gvs      , Gg^Gvs      , Gg^Gvs      , Gg^Gvs      , Gg^Gvs      , Rp          , Gs^Vh       , Gg^Gvs      , Gs^Fms      , Gg          , Ww          , Wo          , Wo          , Wo          , Wo          , Re          , Gd          , Gd          , Gd          
Mm          , Mm          , Mm          , Rp          , Rp          , Gg^Fet      , Cd          , Gs^Fms      , Cd          , Gg^Fet      , Rp          , Kha         , Mm          , Mm^Xm       , Mm^Xm       , Mm^Xm       , Mm          , Mm          , Rrc         , Rrc         , Hh          , Rrc         , Rrc         , Gg^Gvs      , Gg^Gvs      , Gg^Gvs      , Gg^Gvs      , Rp          , Rp          , Gg^Gvs      , Rp          , Rp          , Gg^Gvs      , Gg^Gvs      , Gg^Gvs      , Gg          , Gg          , Ww          , Wo          , Wo          , Wo          , Ww          , Re          , Gd          , Gd          , Gd          
Mm^Xm       , Mm^Xm       , Mm^Xm       , Mm          , Mm          , Rp          , Rr          , Cd          , Gs^Fms      , Cd          , Rr          , Cha         , Mm          , Mm^Xm       , Mm^Xm       , Mm^Xm       , Mm          , Mm          , Rrc         , Hh          , Hh^Fms      , Hh          , Rrc         , Rrc         , Gg^Gvs      , Gg^Gvs      , Gg^Gvs      , Gg^Gvs      , Gs^Vh       , Rp          , Gg^Gvs      , Rp          , Rp          , Gg^Gvs      , Gg^Gvs      , Gg          , Gg^Efm      , Wo          , Wo          , Wo          , Re          , Wwf         , Gd          , Gd          , Gd          , Gd          
Mm^Xm       , Mm^Xm       , Mm^Xm       , Mm^Xm       , Mm^Xm       , Rp          , Rp          , Cd          , Cd          , Cd          , Rp          , Cha         , Mm          , Mm^Xm       , Mm^Xm       , Mm^Xm       , Mm          , Mm          , Rrc         , Hh          , Hhd^Dr      , Hh^Fms      , Hh^Fms      , Rrc         , Gg^Gvs      , Gg^Gvs      , Rp          , Rp          , Gg^Gvs      , Gg^Gvs      , Gg^Gvs      , Gg^Gvs      , Gg^Gvs      , Rp          , Gg          , Gg          , Wo          , Wo          , Wo          , Wo          , Re          , Wwf         , Wwf         , Gs          , Gd          , Gd          
Mm^Xm       , Mm^Xm       , Mm^Xm       , Mm^Xm       , Mm^Xm       , Mm^Xm       , Rp          , Gg^Fet      , Urb         , Gg^Fet      , Rp          , Kha         , Mm          , Mm^Xm       , Mm          , Mm          , Mm          , Rrc         , Hh          , Hh          , Hh^Fms      , Hhd^Dr      , Hh          , Rrc         , Rp          , Rp          , Gg^Gvs      , Gg^Gvs      , Gs^Fms      , Gg^Gvs      , Gg^Gvs      , Gg^Gvs      , Gg^Gvs      , Gg^Gvs      , Gg          , Gg^Efm      , Wo          , Wo          , Wo          , Ww          , Re          , Gd          , Wwf         , Gs          , Gd^Es       , Gd          
Mm^Xm       , Mm^Xm       , Mm^Xm       , Mm^Xm       , Hh          , Rp          , Cha         , Urb         , Urb         , Urb         , Rp          , Cha         , Mm          , Mm^Xm       , Mm          , Mm          , Rrc         , Rrc         , Hh          , Hh^Fms      , Hh^Fms      , Hh          , Rrc         , Rrc         , Gg^Gvs      , Gg^Gvs      , Gg^Gvs      , Gg^Gvs      , Gg^Gvs      , Gg^Gvs      , Gg^Gvs      , Gg^Gvs      , Gg^Gvs      , Gs^Fms      , Gg          , Wo          , Wo          , Wo          , Ww          , Ww          , Re          , Gd          , Wwf         , Gd          , Gd^Es       , Gd          
Mm          , Mm          , Hh          , Hh          , Mm^Xm       , Mm          , Mm          , Cha         , Kha         , Urb         , Kha         , Cha         , Mm^Xm       , Mm^Xm       , Mm          , Mm          , Rrc         , Hh          , Hh          , Hh^Fms      , Hh          , Hh^Vhh      , Rrc         , Rrc         , Rrc         , Gg^Gvs      , Gs^Vh       , Gg^Gvs      , Gg^Gvs      , Gg^Gvs      , Gg^Gvs      , Gg^Gvs      , Gg          , Gs          , Wo          , Wo          , Wo          , Wo          , Ww          , Re          , Gd          , Gd^Es       , Rb          , Sm          , Rb          , Rb          
Hh          , Hh          , Hh^Fp       , Mm          , Mm          , Mm^Xm       , Mm^Xm       , Mm          , Mm          , Urb         , Mm          , Mm^Xm       , Mm          , Mm          , Mm          , Mm          , Rrc         , Hh          , Hh^Fms      , Hh^Vhh      , Gg^Es       , Rr^Vhc      , Rr^Vhc      , Rrc         , Rrc         , Gs^Vh       , Rr^Vhc      , Gs^Vh       , Gg^Gvs      , Gg^Gvs      , Gg          , Gg^Efm      , Gg          , Gg          , Wo          , Wo          , Wo          , Ww          , Re          , Re          , Gd^Es       , Gd          , Wwf         , Sm          , Gs          , Gd          
Gg          , Hh^Fp       , Hh^Fp       , Mm          , Mm          , Mm          , Mm          , Mm          , Mm          , Urb         , Mm          , Mm^Xm       , Mm^Xm       , Mm          , Mm          , Rrc         , Hh          , Hh^Fms      , Hh^Vhh      , Hh          , Gg          , Gs^Vh       , Rr^Vhc      , Rrc         , Rrc         , Rrc         , Rr^Vhc      , Gs^Vh       , Gg          , Gg          , Gg^Efm      , Gg          , Wo          , Wo          , Wo          , Wo          , Re          , Re          , Gd          , Gd^Es       , Gd          , Rb          , Sm          , Gs^Fdw      , Gs          , Gs          
Gg          , Gg          , Hh          , Mm          , Mm          , Mm          , Mm          , Mm          , Mm          , Urb         , Urb         , Mm          , Kha         , Mm          , Rrc         , Rrc         , Mm          , Mm          , Mm          , Gg^Efm      , Gg          , Gs^Vh       , Gs^Vh       , Rr^Vhc      , Rrc         , Rrc         , Rr^Vhc      , Gs^Vh       , Gg^Efm      , Gg          , Wo          , Wo          , Wo          , Wo          , Wo          , Wo          , Re          , Gd          , Gs          , Gd          , Rb          , Wwf         , Sm          , Gs^Es       , Ke          , Gs          
Gs^Fds      , Gs^Fds      , Gg          , Hh^Fp       , Hh          , Mm          , Mm          , Mm          , Mm          , Cha         , Cha         , Urb         , Rrc         , Rrc         , Mm          , Mm          , Mm          , Mm          , Mm          , Hh          , Gg^Es       , Gg^Efm      , Rp          , Rp          , Rr^Vhc      , Rrc         , Rrc         , Gg          , Gg          , Gg          , Wo          , Wo          , Wo          , Wo          , Wo          , Re          , Gd          , Gd          , Gll^Fmf     , Gs          , Rb          , Sm          , Sm^Bw/      , Ce          , Gs          , Gs          
Gs^Fds      , Gs^Fds      , Gs^Fds      , Gg          , Gg          , Hh          , Hh^Fp       , Mm          , Mm          , Mm          , Mm          , Kha         , Mm          , Mm          , Mm          , Mm          , Mm          , Mm          , Hh^Fp       , Hh          , Rp          , Rp          , Gg          , Rr^Vhc      , Gg          , Gg          , Gs^Vct      , Rrc         , Gs^Vct      , Ch          , Wo          , Wo          , Wo          , Ww          , Ww          , Re          , Gd^Es       , Gll^Fmf     , Gd^Es       , Gd          , Sm^Bw/      , Sm^Bw/      , Ss          , Ce          , Gs^Fdw      , Gs          
Gs^Fds      , Gs^Fds      , Gs^Fds      , Gs^Fds      , Gs^Fds      , Gg          , Hh^Fp       , Hh^Fp       , Hh          , Mm          , Mm          , Mm          , Mm          , Mm          , Mm          , Mm          , Hh^Fp       , Hh          , Rp          , Rp          , Gg          , Gg          , Gg^Gvs      , Gg^Gvs      , Ch          , Ch          , Ch          , Rrc         , Re^Vct      , Ch          , Wo          , Wo          , Wo          , Wo          , Ww          , Re          , Gs          , Gs^Es       , Gd          , Gd          , Wwf         , Sm          , Ss          , Ss^Bw|      , Ce          , Gs          
Gs^Fds      , Gs^Fms      , Gs^Fms      , Gs^Fds      , Gs^Fds      , Gg          , Gg          , Gg          , Gg          , Hh^Fp       , Hh^Fp       , Mm          , Mm          , Mm          , Hh^Fp       , Hh          , Re          , Re          , Gg          , Gg          , Gg^Gvs      , Gs^Vh       , Gg^Gvs      , Gg^Gvs      , 4 Kh        , Ch          , Ch          , Rrc         , Rrc         , Kh          , Wo          , Wo          , Wo          , Ww          , Ww          , Re          , Gd          , Gd          , Gd          , Rb          , Wwf         , Sm          , Ce          , Ce          , Ce          , Ko          
Gs^Fds      , Gs^Fds      , Gs^Fds      , Gs^Fds      , Gs^Fds      , Gs^Fds      , Gs^Fds      , Gs^Fds      , Gs^Fds      , Gg          , Gg          , Hh^Fp       , Hh          , Hh^Fp       , Gg          , Re          , Gg          , Gs^Vh       , Gs^Vh       , Gg^Gvs      , Gg^Gvs      , Gg^Gvs      , Gg^Gvs      , Gg^Gvs      , Gs^Vct      , Ch          , Rrc         , Rrc         , 3 Kh        , Ch          , Wo^Bsb\     , Wo          , Kh          , Ww          , Ww          , Re          , Gd^Es       , Gd^Es       , Gd^Es       , Rb          , Wwf         , Sm          , Ce          , Ce          , Ce          , Ce          
Gs^Fds      , Gs^Fds      , Gs^Fds      , Gs^Fds      , Gs^Fms      , Gs^Fms      , Gs^Fds      , Gs^Fms      , Gs^Fds      , Gs^Vl       , Gs^Fds      , Gg          , Gg          , Gg^Es       , Gg^Es       , Re          , Gg          , Gs^Vh       , Gs^Vh       , Gg^Gvs      , Gg^Gvs      , Gg^Gvs      , Gg          , Gg^Es       , Re^Vct      , Gs^Vct      , Kh          , Ch          , Wo^Bsb\     , Wo          , Wo          , Wo^Bsb\     , Ch          , Ww          , Ww          , Re          , Gd          , Gs          , Gd          , Wwf         , Gd          , Sm          , Ce          , Ce          , 5 Kud       , Cud         
Gs^Fds      , Gs^Fds      , Gs^Fds      , Gs^Fds      , Gs^Fds      , Gs^Fds      , Gs^Fds      , Gs^Fds      , Gs^Fds      , Gs^Fms      , Gs^Fds      , Gs^Fds      , Gs^Vl       , Gg          , Re          , Re          , Gg          , Gg          , Gs^Fds      , Gg^Gvs      , Gg^Es       , Gg          , Gg^Gvs      , Gg^Gvs      , Gg^Gvs      , Ch          , Wo          , Wo          , Wo          , Wo^Bsb\     , Wo^Bsb\     , Wo          , Kh          , Ww          , Ww          , Re          , Gd^Es       , Gd          , Gd^Es       , Sm          , Sm^Bw/      , Sm^Bw/      , Gd          , Cud         , Ce          , Cud         
Gs^Fds      , Gs^Fds      , Gs^Fds      , Gs^Fds      , Gs^Fds      , Gs^Fds      , Gs^Fds      , Gs^Fms      , Gs^Fds      , Gs^Fds      , Gs^Fds      , Gs^Fds      , Gll         , Re^Es       , Gs^Fds      , Gs^Fds      , Gs^Fds      , Gs^Vl       , Gs^Fds      , Gs^Fms      , Gg^Gvs      , Gg^Gvs      , Gg^Gvs      , Gg^Gvs      , Gg          , Ch          , Wo          , Wo          , Wo          , Wo          , Wo          , Ch          , Ch          , Ww          , Ww          , Re          , Gd          , Gs          , Gd          , Sm^Bw/      , Sm          , Ss          , Gd          , Ce          , Ce          , Ce          
Gs^Fds      , Gs^Fds      , Gs^Fds      , Gs^Fds      , Gs^Fds      , Gs^Fds      , Gs^Fms      , Gs^Fds      , Gs^Fms      , Gs^Fds      , Gll         , Gll^Es      , Gs^Fds      , Gs^Fds      , Gs^Fds      , Gs^Fms      , Gs^Fds      , Gs^Fms      , Gs^Fds      , Gs^Fds      , Gg^Gvs      , Gg^Gvs      , Gg^Em       , Gg          , Wo          , Wo          , Wo          , Wo          , Wo          , Wo          , Ch          , Kh          , Ch          , Ww^Bw\      , Ww^Bw\      , Re          , Gd          , Gd          , Gd^Es       , Rb          , Sm          , Wwf         , Wwf         , Ce          , Ce          , Ce          
Gs^Fds      , Gs^Fds      , Gs^Fds      , Gs^Fds      , Gs^Fds      , Gs^Fds      , Gs^Fds      , Gs^Fds      , Gs^Fds      , Gs^Fds      , Gll^Es      , Gs^Fds      , Gs^Fds      , Gs^Fms      , Gs^Fds      , Gs^Fds      , Gs^Fms      , Gs^Fds      , Gs^Fds      , Gs^Fms      , Gg^Em       , Gg          , Gg          , Wo          , Wo          , Wo          , Wo          , Wo          , Wo          , Wo          , Wo          , Ch          , Wo          , Ww          , Re          , Gs          , Gd          , Gd^Es       , Gd          , Sm          , Ss          , Sm          , Wwf         , Gs^Bw|      , Gs^Fdw      , Gs          
Gs^Fds      , Gs^Fms      , Gs^Fds      , Gs^Fds      , Gs^Fds      , Gs^Fms      , Gs^Fds      , Gs^Fds      , Gs^Fms      , Gs^Fds      , Gs^Fds      , Gll         , Gll^Es      , Gs^Fds      , Gs^Fds      , Gs^Fds      , Gs^Fds      , Gs^Fds      , Gs^Fds      , Gs^Fds      , Gg          , Gs          , Gg          , Wo          , Wo          , Wo          , Re          , Re          , Re          , Wo          , Wo          , Wo          , Ww          , Ww          , Gd          , Gd          , Gd^Es       , Gd          , Sm^Bw\      , Sm          , Sm          , Sm          , Wwf         , Gs^Bw|      , Ss          , Ss          
Gs^Fds      , Gs^Fds      , Gs^Fds      , Gs^Fms      , Gs^Fds      , Gs^Fds      , Gs^Fms      , Gs^Fds      , Gs^Fds      , Gs^Fds      , Gs^Fds      , Gs^Fds      , Gs^Fds      , Gll         , Gll         , Gs^Fms      , Gs^Fds      , Gs^Fms      , Gs^Fds      , Gs^Fds      , Gs          , Gg          , Wo          , Wo          , Wo          , Wo          , Re          , Re          , Gd^Es       , Re          , Re          , Re          , Gd^Es       , Gd          , Gs          , Gd          , Wwf         , Wwf         , Sm          , Sm^Bw\      , Sm^Bw\      , Wwf         , Ce          , Ss^Bw|      , Ke          , Gs^Fdw      
Gg          , Gs^Fds      , Gs^Fds      , Gs^Fds      , Gs^Fds      , Gs^Fds      , Gs^Fds      , Gs^Fds      , Ce          , Gs^Fds      , Gs^Fds      , Gs^Fds      , Gs^Fms      , Gs^Fms      , Gg          , Gll         , Gs^Fds      , Gs^Fds      , Gs^Fds      , Gs^Fds      , Gs^Fds      , Wo          , Wo          , Wo          , Re          , Re          , Gd          , Gd          , Gd          , Gd          , Gd          , Gd          , Gd          , Gd^Es       , Rb          , Wwf         , Sm          , Sm          , Ss          , Gs          , Wwf         , Ce          , Ce          , Ce          , Gd          , Gd          
Gg          , Gg          , Gs          , Gs          , Gs          , Gs^Fds      , Gs^Fds      , Ke          , Ce          , Ke          , Gll         , Gg          , Gg          , Gg          , Gs          , Gs          , Gs^Fds      , Gs^Fds      , Gs^Fds      , Gs^Fds      , Wo          , Wo          , Wo          , Wo          , Re          , Re          , Gd          , Gd^Es       , Gd          , Gs          , Gd          , Gd^Es       , Rb          , Rb          , Ss          , Sm          , Sm          , Sm          , Wwf         , Gs          , Wwf         , 6 Ke        , Ce          , Ce          , Ce          , Gd          
Gg          , Gs          , Gg          , Gg          , Wo          , Gg          , Wo          , Ce          , Wo          , Ce          , Wo          , Gg          , Wo          , Gg          , Wo          , Gs          , Wwf         , Gs^Fds      , Wo          , Wo          , Wo          , Wo          , Wo          , Re          , Gd          , Gd          , Gs          , Gd          , Gd^Es       , Gd          , Rb          , Rb          , Sm          , Sm          , Gs          , Gs          , Wwf         , Wwf         , Wwf         , Wwf         , Gd          , Ce          , Ke          , Ce          , Gd          , Gg          
Wo          , Wo          , Wo          , Wo          , Wo          , Wo          , Wo          , Wo          , Wo          , Wo          , Wo          , Wo          , Wo          , Wo          , Wo          , Wwf         , Wwf         , Wo          , Wo          , Wo          , Wo          , Wo          , Re          , Re          , Gd          , Gd^Es       , Gd^Es       , Gd          , Gd          , Rb          , Wwf         , Sm          , Ss          , Wwf         , Sm          , Sm          , Gd          , Gd          , Gs          , Gd          , Gs^Es       , Gd          , Gd          , Gs^Fdw      , Gd          , Gg          
Wo          , Wo          , Wo          , Wo          , Wo          , Wo          , Wo          , Wo          , Wo          , Wo          , Wo          , Wo          , Wo          , Wo          , Wo          , Wwf         , Wwf         , Wwf         , Wo          , Wo          , Re          , Re          , Gd          , Gd^Es       , Gd          , Gd          , Gd          , Gd          , Ss          , Sm^Bw\      , Wwf^Bw\     , Sm          , Sm          , Sm          , Ke          , Wwf         , Gd          , Gd^Es       , Gd          , Gs^Fdw      , Gd          , Gg^Es       , Gd          , Gd          , Gd          , Gd          
Wo          , Wo          , Wo          , Wo          , Wo          , Wo          , Wo          , Wo          , Wo          , Wo          , Wo          , Wo          , Wo          , Wo          , Re          , Wwf         , Re          , Wwf         , Re          , Re          , Gd          , Gd          , Gd          , Gd          , Gd          , Gd^Es       , Sm          , Sm          , Ss          , Wwf         , Sm          , Sm^Bw\      , Ke          , Ce          , 7 Ke        , Ce          , Gd          , Gs          , Gd          , Gs^Fdw      , Gd          , Gg          , Gd          , Gd          , Gg          , Gd          
Wo          , Wo          , Re          , Wo          , Re          , Wo          , Re          , Re          , Re          , Wo          , Re          , Re          , Re          , Re          , Re^Es       , Re          , Gd          , Re          , Gd          , Gd^Es       , Gd          , Gd^Es       , Gd          , Gd^Es       , Gd          , Rb          , Sm          , Gd          , Wwf         , Wwf         , Ke          , Ke          , Ce          , Ce          , Ce          , Ce          , Gd          , Gd^Es       , Gd          , Gs          , Gg^Es       , Gd          , Gd          , Gs^Fdw      , Gd          , Gd          
Re          , Re          , Re          , Re          , Re          , Re          , Gd          , Re          , Gd          , Re          , Gd          , Gd          , Gd          , Gd^Es       , Gd          , Gd          , Gd^Edpp     , Gd^Edpp     , Gd^Edpp     , Gd^Edpp     , Gd^Edpp     , Gd          , Gd^Es       , Gd          , Wwf         , Rb          , Sm          , Ss          , Wwf         , Wwf         , Ce          , Ce          , Ce          , Ce          , Gd          , Gd          , Gd^Es       , Gg          , Gg          , Gs          , Gs^Fdw      , Gs          , Gd          , Gd          , Gs          , Gd          
Gd          , Gd          , Gd          , Gd          , Gd          , Gd          , Gd          , Gd          , Gs^Vc       , Gd^Es       , Gd^Edpp     , Gd^Es       , Gs^Vc       , Gd^Edpp     , Gd^Fmw      , Gd^Edpp     , Gd^Dr       , Gd^Edpp     , Gd^Edpp     , Gd^Fmw      , Gd^Fmw      , Gd          , Gd^Es       , Gd          , Wwf         , Wwf         , Wwf         , Wwf         , Sm          , Ce          , Ce          , Ke          , Gd          , Gd          , Gs^Fdw      , Gd          , Gs^Fdw      , Gd          , Gd          , Gs          , Ce          , Gg^Es       , Ke          , Gd          , Gd^Es       , Gs          
Gd          , Gd          , Gd          , Gd          , Gd          , Gd          , Gd          , Gd^Edpp     , Gd^Edpp     , Gd          , Gd^Dr       , Gd^Fmw      , Gd^Edpp     , Gd^Fmw      , Gd^Edp      , Gd^Fmw      , Gd^Edp      , Gd^Edp      , Gd^Edpp     , Gd^Fmw      , Gd^Edpp     , Gd^Edpp     , Gd^Es       , Gd^Es       , Gd^Es       , Rb          , Sm          , Wwf         , Sm          , Ce          , Ce          , Ke          , Gd          , Gd          , Gd^Es       , Gd^Es       , Gd^Es       , Gs^Fdw      , Gd          , Gs^Es       , Ce          , Ce          , Gd          , Gs^Es       , Gd^Es       , Gd          
Gd          , Gd          , Gd          , Gd          , Gd          , Gd          , Gd          , Gd^Edpp     , Gd          , Gd^Edpp     , Gd          , Gd^Edpp     , Gd          , Gd^Edpp     , Gd          , Gd^Fmw      , Gd          , Gd          , Gd          , Gs^Vc       , Gd          , Gd^Edpp     , Gd          , Gd^Es       , Gd          , Rb          , Sm          , Wwf         , Sm          , Ce          , Ce          , Ce          , Gd          , Gd          , Gd          , Gs          , Gd          , Gs          , Gd          , Gd          , Gd          , Ce          , Gd          , Gd          , Gd          , Gd          
