border_size=1
usage=map

Xu          , Xu          , Xu          , Xu          , Xu          , Xu          , Uue         , Uue         , Uue         , Uue         , Uue         , Uue         , Xu          , Xu          , Xu          , Xu          , Xu          , Xu          , Xu          , Xu          , Xu          , Xu          , Xu          , Xu          , Xu          , Urb         , Ur          , Xu          , Xu          , Xu          , Xu          , Xu          , Xu          , Xu          , Xu          , Xu          , Xu          , Ur          , Xu          , Xu          , Xu          , Xu          
Xu          , Xu          , Xu          , Xu          , Xu          , Xu          , Uue         , Uue         , Uue         , Uue         , Uue         , Xu          , Xu          , Xu          , Xu          , Xu          , Xu          , Xu          , Xu          , Xu          , Xu          , Xu          , Xu          , Xu          , Xu          , Xu          , Ur          , Xu          , Xu          , Xu          , Xu          , Xu          , Xu          , Xu          , Xu          , Xu          , Xu          , Ur          , Xu          , Xu          , Xu          , Xu          
Xu          , Xu          , Xu          , Xu          , Xu          , Xu          , Uue         , Uue         , Uue         , Uue         , Uue         , Xu          , Xu          , Xu          , Xu          , Xu          , Xu          , Xu          , Xu          , Xu          , Xu          , Xu          , Xu          , Xu          , Xu          , Xu          , Ur          , Xu          , Xu          , Xu          , Xu          , Xu          , Xu          , Xu          , Xu          , Xu          , Xu          , Ur          , Xu          , Xu          , Xu          , Xu          
Xu          , Xu          , Xu          , Urb         , Urb         , Urb         , Uue         , Uue         , Uue         , Uue         , Uue         , Uue         , Xu          , Xu          , Xu          , Xu          , Xu          , Xu          , Xu          , Xu          , Xu          , Xu          , Xu          , Xu          , Xu          , Xu          , Xu          , Ur          , Ur          , Xu          , Xu          , Xu          , Xu          , Xu          , Xu          , Xu          , Xu          , Ur          , Xu          , Xu          , Xu          , Xu          
Xu          , Xu          , Xu          , Urb         , 1 Urb       , Urb         , Uue         , Uue         , Uue         , Uue         , Uue         , Uue         , Xu          , Xu          , Xu          , Xu          , Xu          , Xu          , Xu          , Xu          , Xu          , Xu          , Xu          , Xu          , Xu          , Xu          , Xu          , Xu          , Ur          , Xu          , Xu          , Xu          , Xu          , Xu          , Xu          , Xu          , Xu          , Ur          , Ai          , Xu          , Ur          , Xu          
Xu          , Xu          , Urb         , Urb         , Urb         , Uue         , Uue         , Uue         , Uue         , Uue         , Uue         , Uue         , Uue         , Xu          , Xu          , Xu          , Xu          , Xu          , Xu          , Xu          , Xu          , Xu          , Xu          , Xu          , Xu          , Xu          , Xu          , Xu          , Ur          , Xu          , Xu          , Xu          , Xu          , Xu          , Xu          , Xu          , Ur          , Ur          , Ur          , Ur          , Xu          , Ur          
Xu          , Xu          , Xu          , Xu          , Xu          , Ur          , Uue         , Uue         , Uue         , Uue         , Uue         , Uue         , Uue         , Xu          , Xu          , Xu          , Xu          , Xu          , Xu          , Xu          , Xu          , Xu          , Xu          , Xu          , Xu          , Xu          , Xu          , Xu          , Ur          , Xu          , Xu          , Xu          , Xu          , Xu          , Xu          , Ur          , Xu          , Ur          , Xu          , Xu          , Xu          , Xu          
Xu          , Xu          , Xu          , Xu          , Xu          , Ur          , Ur          , Uue         , Uue         , Uue         , Uue         , Uue         , Uue         , Xu          , Xu          , Xu          , Xu          , Xu          , Xu          , Xu          , Xu          , Xu          , Xu          , Xu          , Xu          , Xu          , Ur          , Xu          , Ur          , Ur          , Ur          , Ur          , Ur          , Ur          , Ur          , Ur          , Xu          , Xu          , Xu          , Xu          , Xu          , Xu          
Xu          , Xu          , Xu          , Xu          , Xu          , Xu          , Xu          , Ur          , Ur          , Uue         , Uue         , Uue         , Xu          , Xu          , Xu          , Xu          , Xu          , Xu          , Xu          , Xu          , Xu          , Xu          , Xu          , Xu          , Ur          , Ur          , Qxu         , Ur          , Xu          , Xu          , Ww          , Xu          , Xu          , Xu          , Xu          , Xu          , Xu          , Xu          , Xu          , Xu          , Xu          , Xu          
Uue         , Uue         , Uue         , Xu          , Xu          , Xu          , Xu          , Xu          , Xu          , Ur          , Ur          , Xu          , Xu          , Xu          , Xu          , Xu          , Xu          , Xu          , Xu          , Xu          , Xu          , Xu          , Ur          , Ur          , Xu          , Qxu         , Xu          , Xu          , Xu          , Ww          , Ww          , Ww          , Xu          , Xu          , Xu          , Xu          , Xu          , Xu          , Xu          , Xu          , Xu          , Xu          
Uue         , Uue         , Uue         , Xu          , Xu          , Xu          , Xu          , Xu          , Xu          , Xu          , Xu          , Ur          , Ur          , Xu          , Xu          , Xu          , Xu          , Xu          , Xu          , Xu          , Ur          , Ur          , Urb         , Xu          , Xu          , Qxu         , Qxu         , Xu          , Xu          , Ww          , Ww          , Ww          , Xu          , Xu          , Xu          , Xu          , Xu          , Xu          , Xu          , Xu          , Xu          , Xu          
Uue         , Uue         , Uue         , Xu          , Xu          , Xu          , Xu          , Xu          , Xu          , Xu          , Xu          , Xu          , Xu          , Ur          , Xu          , Xu          , Xu          , Xu          , Xu          , Xu          , Ur          , Urb         , Urb         , Urb         , Urb         , Xu          , Qxu         , Xu          , Xu          , Xu          , Ww          , Xu          , Xu          , Xu          , Xu          , Xu          , Xu          , Xu          , Xu          , Xu          , Xu          , Xu          
Uue         , Uue         , Uue         , Xu          , Xu          , Xu          , Xu          , Xu          , Xu          , Xu          , Xu          , Xu          , Xu          , Ur          , Xu          , Xu          , Ur          , Xu          , Xu          , Xu          , Ur          , Urb         , Urb         , Urb         , Urb         , Urb         , Qxu         , Xu          , Xu          , Xu          , Ww          , Xu          , Xu          , Xu          , Xu          , Xu          , Xu          , Xu          , Xu          , Xu          , Xu          , Xu          
Uue         , Uue         , Uue         , Xu          , Xu          , Xu          , Xu          , Xu          , Xu          , Xu          , Xu          , Xu          , Xu          , Ur          , Ur          , Ur          , Urb         , Ur          , Ur          , Ur          , Urb         , Urb         , Urb         , Urb         , Urb         , Urb         , Qxu         , Xu          , Xu          , Xu          , Xu          , Xu          , Xu          , Xu          , Xu          , Xu          , Xu          , Xu          , Xu          , Xu          , Xu          , Xu          
Uue         , Uue         , Uue         , Uue         , Xu          , Xu          , Xu          , Xu          , Xu          , Xu          , Xu          , Xu          , Xu          , Xu          , Ur          , Urb         , Urb         , Urb         , Urb         , Urb         , Urb         , Urb         , Urb         , Urb         , Urb         , Urb         , Qxu         , Qxu         , Xu          , Xu          , Xu          , Xu          , Xu          , Xu          , Xu          , Xu          , Xu          , Xu          , Xu          , Xu          , Xu          , Xu          
Uue         , Uue         , Uue         , Xu          , Xu          , Xu          , Xu          , Xu          , Xu          , Xu          , Ur          , Ur          , Ur          , Ur          , Ur          , Urb         , Urb         , Urb         , Urb         , Urb         , Urb         , Urb         , Urb         , Urb         , Urb         , Urb         , Xuc         , Xuc         , Qxu         , Qxu         , Xu          , Xu          , Xu          , Xu          , Xu          , Xu          , Xu          , Xu          , Xu          , Xu          , Xu          , Xu          
Uue         , Uue         , Hhd         , Xu          , Xu          , Xu          , Xu          , Xu          , Xu          , Ur          , Xuc         , Xuc         , Xuc         , Xuc         , Xuc         , Ur          , Urb         , Urb         , Urb         , Urb         , Urb         , Urb         , Urb         , Urb         , Ql          , Xuc         , Xuc         , Xuc         , Xuc         , Xuc         , Xuc         , Xuc         , Xuc         , Xuc         , Xu          , Xu          , Xu          , Xu          , Qxu         , Xu          , Xu          , Xu          
Uue         , Uue         , Uue         , Xu          , Xu          , Xu          , Xu          , Xu          , Ur          , Ur          , Xuc         , Xuc         , Xuc         , Xuc         , Xuc         , Ur          , Ur          , Urb         , Urb         , Urb         , Urb         , Urb         , Urb         , Ql          , Urb         , Xuc         , Xuc         , Xuc         , Xuc         , Xuc         , Xuc         , Xuc         , Xuc         , Xuc         , Xu          , Xu          , Xu          , Xu          , Xu          , Qxu         , Xu          , Xu          
Uue         , Uue         , Uue         , Uue         , Uue         , Uue         , Uue         , Uue         , Ur          , Xuc         , Xuc         , Xuc         , Xuc         , Xuc         , Xuc         , Xuc         , Xuc         , Ur          , Urb         , Urb         , Urb         , Urb         , Urb         , Ql          , Urb         , Cud         , Cud         , Xuc         , Xuc         , Xuc         , Xuc         , Xuc         , Xuc         , Xuc         , Xuc         , Xu          , Xu          , Xu          , Xu          , Qxu         , Qxu         , Xu          
Uue         , Uue         , Uue         , Uue         , Uue         , Uue         , Ur          , Ur          , Xuc         , Xuc         , Xuc         , Xuc         , Xuc         , Xuc         , Xuc         , Xuc         , Xuc         , Ur          , Urb         , Ql          , Ql          , Urb         , Urb         , Ql          , Urb         , Urb         , Kud         , Cud         , Cud         , Xuc         , Xuc         , Xuc         , Xuc         , Xuc         , Xuc         , Xu          , Xu          , Xu          , Xu          , Qxu         , Qxu         , Qxu         
Uue         , Uue         , Uue         , Uue         , Uue         , Ur          , Xuc         , Xuc         , Xuc         , Xuc         , Xuc         , Xuc         , Xuc         , Xuc         , Xuc         , Xuc         , Uh          , Ur          , Ur          , Urb         , Urb         , Ql          , Ql          , Ql          , Urb         , Urb         , Urb         , Cud         , Cud         , Xuc         , Xuc         , Xuc         , Xuc         , Xuc         , Xuc         , Xu          , Qxu         , Qxu         , Qxu         , Qxu         , Xu          , Xu          
Uue         , Uue         , Uue         , Uue         , Ur          , Ur          , Xuc         , Xuc         , Xuc         , Xuc         , Xuc         , Xuc         , Xuc         , Xuc         , Xuc         , Xuc         , Urb         , Urb         , Urb         , Ur          , Ur          , Ql          , Ur          , Urb         , Urb         , Urb         , Urb         , Cud         , Urb         , Xuc         , Xuc         , Xuc         , Xuc         , Xuc         , Xuc         , Xuc         , Qxu         , Qxu         , Qxu         , Xu          , Qxu         , Qxu         
Uue         , Uue         , Uue         , Ur          , Uu          , Uu          , Uu          , Xuc         , Xuc         , Xuc         , Xuc         , Xuc         , Xuc         , Xuc         , Urb         , Urb         , Urb         , Urb         , Urb         , Urb         , Urb         , Ur          , Urb         , Ur          , Urb         , Urb         , Urb         , Urb         , Urb         , Xuc         , Uu^Uf       , Xuc         , Xuc         , Xuc         , Xuc         , Hhd         , Qxu         , Qxu         , Qxu         , Qxu         , Xu          , Hhd         
Uue         , Uue         , Uue         , Ur          , Uu          , Uu          , Uu          , Xuc         , Xuc         , Xuc         , Xuc         , Xuc         , Ql          , Urb         , Xuc         , Xuc         , Urb         , Urb         , Urb         , Urb         , Urb         , Urb         , Urb         , Ur          , Urb         , Urb         , Urb         , Urb         , Urb         , Urb         , Uu^Uf       , Uu^Ufi      , Xuc         , Uu^Uf       , Qxu         , Qxu         , Qxu         , Xu          , Xu          , Xu          , Xu          , Xu          
Uue         , Uue         , Uue         , Ur          , Uu          , Uu          , Uu          , Uu          , Xuc         , Xuc         , Xuc         , Xuc         , Ql          , Ql          , Xuc         , Uh          , Urb         , Urb         , Urb         , Urb         , Urb         , Urb         , Urb         , Ur          , Urb         , Urb         , Urb         , Urb         , Urb         , Uu^Uf       , Uu^Uf       , Uu^Uf       , Uu^Ufi      , Uu^Ufi      , Gd          , Gd          , Uue         , Xu          , Xu          , Xu          , Xu          , Xu          
Uue         , Uue         , Ur          , Ur          , Uu          , Uu          , Uu          , Uu          , Xuc         , Xuc         , Xuc         , Xuc         , Ql          , Xuc         , Ql          , Uh          , Urb         , Uh          , Uh          , Urb         , Urb         , Urb         , Urb         , Ur          , Urb         , Urb         , Urb         , Urb         , Urb         , Uu^Uf       , Uu^Uf       , Uu^Ufi      , Uue         , Uue         , Uue         , Uue         , Uue         , Uue         , Uue         , Xu          , Xu          , Xu          
Uue         , Ur          , Uu          , Uu          , Uu          , Uu          , Xuc         , Xuc         , Xuc         , Xuc         , Xuc         , Xuc         , Xuce        , Ql          , Uue         , Uue         , Urb         , Uue         , Uh          , Urb         , Urb         , Urb         , Urb         , Ur          , Ur          , Urb         , Urb         , Urb         , Ur          , Uu^Uf       , Uue         , Uue         , Uue         , Uue         , Uue         , Uue         , Uue         , Uue         , Uue         , Uue         , Uue         , Xu          
Ur          , Ur          , Uu          , Uu          , Uu          , Xuc         , Xuc         , Xuc         , Xuc         , Xuc         , Xuc         , Xuce        , Xuce        , Xuce        , Xuce        , Uue         , Urb         , Uue         , Uue         , Urb         , Urb         , Urb         , Urb         , Urb         , Urb         , Ur          , Ur          , Ur          , Xuce        , Ur          , Ur          , Uue         , Uue         , Uue         , Uue         , Uue         , Xu          , Xu          , Xu          , Uue         , Uue         , Uue         
Uu          , Uu          , Uu          , Uu          , Xuc         , Xuc         , Xuc         , Xuc         , Xuc         , Xuc         , Ql          , Xuce        , Xuce        , Xuce        , Xuce        , Xuce        , Xuce        , Urb         , Urb         , Urb         , Uh          , Urb         , Urb         , Urb         , Urb         , Urb         , Urb         , Urb         , Uh          , Xuce        , Xuce        , Ur          , Ur          , Ur          , Ur          , Xu          , Xu          , Xu          , Xu          , Xu          , Ww          , Xu          
Uu          , Uu          , Uu          , Uu          , Xuc         , Xuc         , Xuc         , Xuc         , Xuc         , Xuc         , Ql          , Uue         , Uue         , Xuce        , Xuce        , Xuce        , Xuce        , Xuce        , Uue         , Qxe         , Xuce        , Xuce        , Xuce        , Xuce        , Xuce        , Xuce        , Xuce        , Xuce        , Xuce        , Xuce        , Xuce        , Xuce        , Xuce        , Xuce        , Xuce        , Ur          , Ur          , Xu          , Ww          , Ww          , Ww          , Xu          
Uu          , Uu          , Uu          , Uu          , Xuc         , Xuc         , Ql          , Xuc         , Ql          , Ql          , Ql          , Uue         , Uue         , Uue         , Uue         , Xuce        , Xuce        , Xuce        , Qxe         , Qxe         , Xuce        , Xuce        , Xuce        , Xuce        , Xuce        , Xuce        , Xuce        , Xuce        , Xuce        , Xuce        , Hhd         , Xuce        , Xuce        , Xuce        , Hhd         , Xuce        , Ur          , Xu          , Ww          , Ww          , Ww          , Xu          
Uu          , Uu          , Ql          , Xuc         , Xuc         , Ql          , Uue         , Ql          , Uue         , Ql          , Ql          , Ql          , Uue         , Uue         , Uue         , Uue         , Uue         , Uue         , Uue         , Qxe         , Xuce        , Xuce        , Xuce        , Xuce        , Xuce        , Xuce        , Xuce        , Qxe         , Qxe         , Hhd         , Xuce        , Xuce        , Xuce        , Xuce        , Xuce        , Hhd         , Ur          , Xu          , Xu          , Xu          , Ww          , Ww          
Uu          , Uu          , Uu          , Ql          , Ql          , Ql          , Uue         , Uue         , Uue         , Ql          , Ql          , Uue         , Uue         , Uue         , Uue         , Uue         , Uue         , Uue         , Xuce        , Qxe         , Xuce        , Xuce        , Qxe         , Xuce        , Xuce        , Xuce        , Xuce        , Qxe         , Qxe         , Qxe         , Qxe         , Xuce        , Xuce        , Xuce        , Xuce        , Hhd         , Ur          , Xu          , Xu          , Xu          , Xu          , Ww          
Uu          , Uu          , Uu          , Ql          , Ql          , Uue         , Uue         , Uue         , Uue         , Uue         , Uue         , Uue         , Uue         , Uue         , Uue         , Uue         , Uue         , Uue         , Uue         , Qxe         , Qxe         , Qxe         , Qxe         , Qxe         , Qxe         , Xuce        , Qxe         , Qxe         , Qxe         , Qxe         , Qxe         , Xuce        , Xuce        , Qxe         , Xuce        , Hhd         , Gd          , Ur          , Xu          , Xu          , Xu          , Ww          
Uu          , Uu          , Ql          , Ql          , Ql          , Ql          , Uue         , Uue         , Uue         , Uue         , Uue         , Uue         , Uue         , Uue         , Uue         , Uue         , Uue         , Uue         , Qxe         , Qxe         , Qxe         , Qxe         , Qxe         , Uue         , Qxe         , Qxe         , Xuce        , Qxe         , Qxe         , Qxe         , Qxe         , Qxe         , Qxe         , Qxe         , Qxe         , Hhd         , Gd          , Ur          , Xu          , Xu          , Xu          , Ww          
Uu          , Ql          , Ql          , Ql          , Ql          , Ql          , Ql          , Uue         , Uue         , Uue         , Uue         , Uue         , Uue         , Uue         , Uue         , Uue         , Uue         , Uue         , Uue         , Qxe         , Qxe         , Qxe         , Uue         , Uue         , Uue         , Uue         , Uue         , Qxe         , Qxe         , Qxe         , Qxe         , Qxe         , Xuce        , Xuce        , Xuce        , Xuce        , Xuce        , Xuce        , Xu          , Xu          , Xu          , Xu          
Uu          , Ql          , Uu          , Uu          , Uue         , Ql          , Uue         , Uue         , Uue         , Uue         , Uue         , Uue         , Uue         , Uue         , Uue         , Uue         , Uue         , Uue         , Uue         , Qxe         , Qxe         , Uue         , Uue         , Uue         , Uue         , Uue         , Uue         , Xuce        , Xuce        , Qxe         , Qxe         , Qxe         , Xuce        , Xuce        , Xuce        , Xuce        , 2 Xu        , Xuce        , Xu          , Xu          , Xu          , Xu          
Uu          , Uu          , Uue         , Uu          , Uue         , Ql          , Ql          , Uue         , Uue         , Uue         , Uue         , Uue         , Uue         , Uue         , Uue         , Uue         , Urb         , Urb         , Urb         , Uue         , Uue         , Uue         , Uue         , Uue         , Uue         , Uue         , Uue         , Uue         , Uue         , Uue         , Qxe         , Xuce        , Xuce        , Xuce        , Xuce        , Xuce        , Xuce        , Xu          , Xu          , Xu          , Xu          , Xu          
Ql          , Uu          , Uue         , Uue         , Ql          , Ql          , Ql          , Ql          , Ql          , Ql          , Ql          , Uue         , Uue         , Uue         , Urb         , Urb         , Urb         , Urb         , Urb         , Urb         , Uue         , Uue         , Uue         , Uue         , Uue         , Uue         , Uue         , Uue         , Uue         , Uue         , Xu          , Xu          , Xu          , Xu          , Xu          , Xu          , Xu          , Xu          , Xu          , Xu          , Xu          , Xu          
Uu          , Uu          , Uue         , Uue         , Ql          , Ql          , Uue         , Uue         , Uue         , Uue         , Uue         , Xuce        , Uue         , Uue         , Urb         , Urb         , Urb         , Urb         , Urb         , Urb         , Uue         , Uue         , Qxe         , Qxe         , Uue         , Uue         , Uue         , Uue         , Uue         , Uue         , Uue         , Xu          , Xu          , Xu          , Xu          , Xu          , Xu          , Xu          , Xu          , Xu          , Xu          , Xu          
Uu          , Uu          , Uue         , Uue         , Ql          , Ql          , Uue         , Uue         , Uue         , Xuce        , Uue         , Uue         , Uue         , Urb         , Urb         , Urb         , Urb         , Urb         , Urb         , Urb         , Uue         , Qxe         , Qxe         , Qxe         , Uue         , Ww          , Uue         , Uue         , Uue         , Uue         , Uue         , Xu          , Xu          , Xu          , Xu          , Xu          , Xu          , Xu          , Xu          , Xu          , Xu          , Xu          
Uu          , Uue         , Uue         , Uue         , Uue         , Ql          , Uue         , Uue         , Xuce        , Xuce        , Uue         , Uue         , Uue         , Uue         , Urb         , Urb         , Urb         , Xuce        , Urb         , Urb         , Gd          , Uue         , Uue         , Uue         , Ai          , Ww          , Gd          , Uue         , Uue         , Uue         , Xu          , Xu          , Xu          , Xu          , Xu          , Xu          , Xu          , Xu          , Xu          , Xu          , Xu          , Xu          
