border_size=1
usage=map

Aa^Fpa      , Aa^Fpa      , Aa^Fpa      , Aa^Fpa      , Aa^Fpa      , Aa^Fpa      , Gll^Fp      , Aa^Fpa      , Aa^Fpa      , Aa^Fpa      , Aa^Fpa      , Gd          , Aa          , Aa          , Aa          , Ha          , Ha          , Ha          , Ms          , Ha          , Ha          , Ha          , Ha          , Ha          , Ha          , Gd          , Ha          , Aa          , Aa          , Aa          , Hhd         , Hhd         , Ha          , Aa          , Aa          , Aa          , Aa          , Ha          , Aa          , Ai          , Ai          , Ww          
Gd          , Gd          , Gd          , Aa^Fpa      , Aa^Fpa      , Aa^Fpa      , Gll^Fp      , Gll^Fp      , Gll^Fp      , Gll^Fp      , Aa^Fpa      , Aa          , Aa          , Aa          , Aa          , Ha          , Ha          , Ha          , Ha          , Aa          , Aa          , Ha          , Hhd         , Mm          , Hhd         , Ha          , Ha          , Ha          , Ha          , Ha          , Hhd         , Hhd         , Ha          , Aa          , Aa          , Aa          , Aa          , Ha          , Aa          , Ai          , Ai          , Ww          
Gd          , Gd          , Gd          , Aa^Fpa      , Aa^Fpa      , Aa^Fpa      , Gll^Fp      , Gll^Fp      , Gll^Fp      , Aa^Fpa      , Aa^Fpa      , Aa          , Aa          , Aa          , Aa          , Ha          , Ha          , Ha          , Ha          , Aa          , Ha          , Ha          , Hhd         , Hhd         , Hhd         , Hhd         , Ha          , Aa          , Ha          , Ha          , Ha          , Ha          , Aa          , Aa          , Aa          , Aa          , Aa          , Ha          , Aa          , Ai          , Ai          , Ww          
Aa          , Gd          , Gd          , Ch          , Ch          , Ch          , Gll^Fp      , Gll^Fp      , Gll^Fp      , Gll^Fp      , Aa^Fpa      , Gd          , Aa          , Aa          , Aa          , Ha          , Ha          , Aa          , Aa          , Gd          , Gd          , Hhd         , Hhd         , Hhd         , Hhd         , Hhd         , Hhd         , Ha          , Ha          , Aa          , Aa          , Aa          , Aa          , Aa          , Aa          , Aa          , Aa          , Ha          , Aa          , Ai          , Ai          , Aa          
Ha          , Ha          , Hhd         , Ch          , 1 Kh        , Ch          , Gll^Fp      , Gll^Fp      , Gll^Fp      , Gll^Fp      , Aa^Fpa      , Gd          , Aa          , Aa          , Aa          , Ha          , Ha          , Ha          , Aa          , Aa^Fpa      , Aa^Fpa      , Aa^Fpa      , Aa^Fpa      , Aa^Fpa      , Aa^Fpa      , Aa^Fpa      , Gd          , Aa          , Ha          , Aa          , Aa          , Aa          , Aa          , Aa          , Aa          , Aa          , Aa          , Ha          , Ai          , Aa          , Ha          , Aa          
Ha          , Ha          , Ch          , Ch          , Ch          , Gd          , Gll^Fp      , Gll^Fp      , Gll^Fp      , Gll^Fp      , Gll^Fp      , Aa^Fpa      , Gd          , Aa          , Aa          , Ha          , Ha          , Ha          , Ha          , Aa^Fpa      , Gll^Fp      , Gll^Fp      , Gll^Fp      , Aa^Fpa      , Aa^Fpa      , Aa^Fpa      , Gd          , Aa          , Ha          , Aa          , Aa          , Aa          , Aa          , Aa          , Aa          , Aa          , Ha          , Ha          , Ha          , Ha          , Gd          , Ha          
Ha          , Ha          , Ha          , Ha          , Ha          , Ha          , Aa^Fpa      , Aa^Fpa      , Aa^Fpa      , Gll^Fp      , Gll^Fp      , Aa^Fpa      , Gd          , Aa          , Aa          , Ha          , Ha          , Ha          , Ha          , Gd          , Aa^Fpa      , Gll^Fp      , Gll^Fp      , Gll^Fp      , Aa^Fpa      , Gd          , Gd          , Gd          , Ha          , Aa          , Aa          , Aa          , Aa          , Aa          , Aa          , Ha          , Gd          , Ha          , Gd          , Aa^Fpa      , Aa^Fpa      , Aa^Fpa      
Ha          , Ha          , Ha          , Ha          , Gd          , Ha          , Ha          , Gd          , Aa^Fpa      , Aa^Fpa      , Gll^Fp      , Aa^Fpa      , Gd          , Aa          , Aa          , Ha          , Ha          , Ha          , Ha          , Aa^Fpa      , Gll^Fp      , Gll^Fp      , Gll^Fp      , Aa^Fpa      , Aa^Fpa      , Gd          , Ha          , Aa          , Ha          , Ha          , Ha          , Ha          , Ha          , Ha          , Ha          , Ha          , Gd          , Gd          , Gd          , Aa^Fpa      , Aa^Fpa      , Gll^Fp      
Aa^Fpa      , Aa^Fpa      , Aa^Fpa      , Aa^Fpa      , Aa          , Aa          , Gd          , Ha          , Ha          , Aa^Fpa      , Aa^Fpa      , Gd          , Aa          , Aa          , Aa          , Aa          , Aa          , Ha          , Ha          , Aa^Fpa      , Aa^Fpa      , Aa^Fpa      , Aa^Fpa      , Aa^Fpa      , Ha          , Ha          , Aa^Fpa      , Ha          , Gd          , Aa^Fpa      , Ww          , Ai          , Aa          , Aa          , Aa          , Aa          , Aa          , Gd          , Gd          , Aa^Fpa      , Aa^Fpa      , Aa^Fpa      
Gll^Fp      , Gll^Fp      , Gll^Fp      , Aa^Fpa      , Aa          , Gd          , Aa^Fpa      , Aa^Fpa      , Aa^Fpa      , Ha          , Ha          , Aa          , Aa          , Aa          , Aa          , Aa          , Aa          , Aa          , Gd          , Gd          , Aa^Fpa      , Gd          , Ha          , Ha          , Gd          , Aa^Fpa      , Gll^Fp      , Gll^Fp      , Gll^Fp      , Ww          , Ww          , Ww          , Aa          , Aa          , Aa          , Aa          , Aa          , Aa          , Gd          , Gd          , Aa^Fpa      , Gd          
Hhd         , Gd          , Gll^Fp      , Aa^Fpa      , Aa          , Aa^Fpa      , Gll^Fp      , Gll^Fp      , Aa^Fpa      , Aa^Fpa      , Aa          , Ha          , Ha          , Aa          , Aa          , Aa          , Aa          , Aa          , Gd          , Gd          , Ha          , Ha          , Aa          , Aa          , Aa          , Aa^Fpa      , Aa^Fpa      , Gd          , Gd          , Ww          , Ww          , Ww          , Aa          , Aa          , Aa          , Aa          , Aa          , Aa          , Aa          , Gd          , Aa          , Aa          
Hhd         , Hhd         , Gll^Fp      , Aa^Fpa      , Gd          , Aa^Fpa      , Gll^Fp      , Gd          , Gll^Fp      , Ww          , Ww          , Aa          , Aa          , Ha          , Aa          , Aa          , Aa          , Aa          , Aa          , Aa          , Ha          , Ha          , Ha          , Ha          , Aa          , Gd          , Aa^Fpa      , Gd          , Gd          , Gd          , Ww          , Gd          , Aa          , Aa          , Aa          , Aa          , Aa          , Aa          , Aa          , Aa          , Aa          , Aa          
Mm          , Hhd         , Gll^Fp      , Aa^Fpa      , Gd          , Aa^Fpa      , Gll^Fp      , Gll^Fp      , Ww          , Ww          , Ww          , Gd          , Aa          , Ha          , Aa          , Aa          , Ha          , Aa          , Aa          , Aa          , Ha          , Ha          , Ha          , Ha          , Ha          , Aa          , Aa^Fpa      , Gll^Fp      , Gd          , Gd          , Ww          , Aa^Fpa      , Aa          , Aa          , Aa          , Aa          , Aa          , Aa          , Aa          , Aa          , Aa          , Aa          
Mm          , Hhd         , Hhd         , Aa^Fpa      , Aa^Fpa      , Gll^Fp      , Gll^Fp      , Aa^Fpa      , Aa^Fpa      , Gd          , Aa^Fpa      , Gd          , Aa          , Ha          , Ha          , Ha          , Aa          , Ha          , Ha          , Ha          , Aa          , Ha          , Ha          , Ha          , Ha          , Ha          , Aa^Fpa      , Gll^Fp      , Gd          , Gd          , Gll^Fp      , Aa^Fpa      , Gd          , Aa          , Aa          , Aa          , Aa          , Aa          , Aa          , Aa          , Aa          , Aa          
Mm          , Mm          , Hhd         , Gd          , Aa^Fpa      , Aa^Fpa      , Aa^Fpa      , Aa^Fpa      , Gd          , Gd          , Aa^Fpa      , Gd          , Aa          , Aa          , Ha          , Aa          , Aa          , Aa          , Aa          , Ha          , Aa          , Ha          , Ha          , Ha          , Ha          , Aa          , Aa^Fpa      , Aa^Fpa      , Gll^Fp      , Gll^Fp      , Gll^Fp      , Aa^Fpa      , Ha          , Gd          , Gd          , Gd          , Gd          , Gd          , Gd          , Aa^Fpa      , Gd          , Gd          
Ms          , Ms          , Ha          , Aa^Fpa      , Aa^Fpa      , Gll^Fp      , Aa^Fpa      , Gd          , Gd          , Aa          , Ha          , Ha          , Ha          , Ha          , Ha          , Aa          , Aa          , Aa          , Ha          , Ha          , Aa          , Ha          , Ha          , Ha          , Aa          , Aa          , Ha          , Ha          , Aa^Fpa      , Aa^Fpa      , Hhd         , Hhd         , Hhd         , Hhd         , Aa^Fpa      , Aa^Fpa      , Gll^Fp      , Gll^Fp      , Aa^Fpa      , Aa^Fpa      , Aa^Fpa      , Aa^Fpa      
Ms          , Ha          , Hhd         , Aa^Fpa      , Aa^Fpa      , Aa^Fpa      , Aa^Fpa      , Aa^Fpa      , Gd          , Ha          , Aa          , Aa          , Aa          , Aa          , Aa          , Ha          , Aa          , Aa          , Aa          , Ha          , Ha          , Aa          , Aa          , Aa          , Aa          , Ha          , Ha          , Ha          , Ha          , Ha          , Ha          , Ms          , Ms          , Ms          , Hhd         , Gll^Fp      , Gd          , Gd          , Gll^Fp      , Aa^Fpa      , Aa^Fpa      , Gd          
Aa          , Aa          , Gd          , Aa^Fpa      , Aa^Fpa      , Aa^Fpa      , Aa^Fpa      , Gd          , Ha          , Ha          , Aa          , Aa          , Aa          , Aa          , Aa          , Ha          , Ha          , Aa          , Aa          , Aa          , Aa          , Aa          , Aa          , Aa          , Aa          , Ha          , Ha          , Ha          , Ms          , Ms          , Ms          , Ms          , Ms          , Ms          , Hhd         , Gd          , Gd          , Gd          , Gd          , Gll^Fp      , Aa^Fpa      , Gd          
Aa          , Aa          , Gd          , Gd          , Gd          , Aa          , Aa          , Aa          , Ha          , Aa          , Aa          , Aa          , Aa          , Aa          , Aa          , Aa          , Aa          , Ha          , Aa          , Aa          , Aa          , Aa          , Aa          , Aa          , Aa          , Aa          , Aa          , Ha          , Ms          , Ms          , Ms          , Ms          , Ms          , Ms          , Ms          , Hhd         , Gd          , Gd          , Gd          , Gll^Fp      , Gll^Fp      , Aa^Fpa      
Aa          , Gd          , Gd          , Aa          , Aa          , Aa          , Ha          , Ha          , Aa          , Aa          , Aa^Fpa      , Hhd         , Aa^Fpa      , Aa          , Aa          , Aa          , Aa          , Ha          , Aa          , Aa          , Aa          , Aa          , Aa          , Aa          , Aa          , Aa          , Ha          , Ha          , Ha          , Ms          , Ms          , Ms          , Ms          , Ms          , Ms          , Hhd         , Gd          , Gd          , Gd          , Gll^Fp      , Gll^Fp      , Gll^Fp      
Aa          , Gd          , Gd          , Aa          , Aa          , Ha          , Aa          , Aa          , Aa^Fpa      , Gll^Fp      , Gll^Fp      , Gll^Fp      , Aa^Fpa      , Aa          , Aa          , Aa          , Aa          , Ha          , Ha          , Aa          , Aa          , Aa          , Aa          , Aa          , Ha          , Ha          , Aa^Fpa      , Aa^Fpa      , Aa          , Ms          , Ms          , Ms          , Ms          , Ms          , Ms          , Hhd         , Gll^Fp      , Gll^Fp      , Gll^Fp      , Gll^Fp      , Gd          , Aa^Fpa      
Aa          , Aa          , Aa          , Aa          , Ha          , Ha          , Aa          , Aa          , Aa^Fpa      , Gll^Fp      , Gll^Fp      , Aa^Fpa      , Aa^Fpa      , Aa^Fpa      , Aa          , Aa          , Aa          , Aa^Fpa      , Aa^Fpa      , Ha          , Ha          , Aa          , Ha          , Aa          , Ha          , Aa^Fpa      , Aa^Fpa      , Aa^Fpa      , Aa^Fpa      , Aa          , Ms          , Ms          , Ms          , Ms          , Ms          , Ms          , Gll^Fp      , Gll^Fp      , Gll^Fp      , Gd          , Gll^Fp      , Gll^Fp      
Aa          , Aa          , Aa          , Ha          , Aa          , Aa          , Ai          , Aa          , Aa^Fpa      , Gll^Fp      , Aa^Fpa      , Aa^Fpa      , Aa^Fpa      , Gll^Fp      , Aa^Fpa      , Aa^Fpa      , Aa^Fpa      , Aa^Fpa      , Aa^Fpa      , Aa^Fpa      , Aa          , Ha          , Aa          , Ha          , Aa^Fpa      , Ww          , Ha          , Ha          , Aa^Fpa      , Aa^Fpa      , Aa          , Ms          , Ms          , Ms          , Ms          , Hhd         , Aa^Fpa      , Gll^Fp      , Gll^Fp      , Gll^Fp      , Aa^Fpa      , Hhd         
Aa          , Aa          , Aa          , Ha          , Aa          , Aa          , Ai          , Aa          , Aa          , Aa^Fpa      , Aa^Fpa      , Aa^Fpa      , Gll^Fp      , Aa^Fpa      , Aa^Fpa      , Aa^Fpa      , Aa^Fpa      , Aa^Fpa      , Aa^Fpa      , Aa^Fpa      , Aa^Fpa      , Aa^Fpa      , Aa          , Ha          , Ww          , Ww          , Ww          , Aa^Fpa      , Aa^Fpa      , Ha          , Aa          , Ms          , Ms          , Ms          , Aa^Fpa      , Aa^Fpa      , Aa^Fpa      , Gd          , Aa^Fpa      , Aa^Fpa      , Hhd         , Mm          
Aa          , Aa          , Aa          , Ha          , Aa          , Aa          , Aa          , Aa          , Aa          , Aa^Fpa      , Aa^Fpa      , Aa^Fpa      , Gll^Fp      , Gll^Fp      , Aa^Fpa      , Ha          , Aa^Fpa      , Aa^Fpa      , Aa^Fpa      , Ha          , Ha          , Aa^Fpa      , Aa          , Ha          , Ww          , Ww          , Ww          , Ww          , Ha          , Ha          , Aa          , Ha          , Ha          , Ha          , Gd          , Gd          , Aa          , Gd          , Gd          , Gd          , Hhd         , Mm          
Aa          , Aa          , Ha          , Ha          , Aa          , Aa          , Aa          , Aa          , Aa          , Aa          , Aa^Fpa      , Aa^Fpa      , Gll^Fp      , Aa^Fpa      , Ha          , Ha          , Ha          , Ha          , Ha          , Ha          , Ha          , Ha          , Aa^Fpa      , Ha          , Ww          , Ww          , Ww          , Ai          , Ha          , Aa          , Aa          , Ha          , Aa          , Aa          , Aa          , Aa          , Aa          , Aa          , Aa          , Gd          , Ha          , Ms          
Aa          , Ha          , Aa          , Aa          , Aa          , Aa          , Aa          , Aa          , Aa^Fpa      , Aa^Fpa      , Aa^Fpa      , Aa^Fpa      , Aa^Fpa      , Ha          , Aa          , Aa          , Aa          , Aa          , Ha          , Aa^Fpa      , Aa^Fpa      , Ha          , Ha          , Ha          , Ha          , Ai          , Ai          , Ai          , Ha          , Aa          , Aa          , Aa          , Aa          , Aa          , Aa          , Aa          , Aa          , Aa          , Aa          , Aa          , Aa          , Ms          
Ha          , Ha          , Gd          , Gd          , Gd          , Aa^Fpa      , Aa^Fpa      , Aa^Fpa      , Aa^Fpa      , Aa^Fpa      , Aa^Fpa      , Gd          , Gd          , Aa          , Aa          , Aa          , Aa          , Aa          , Aa          , Aa^Fpa      , Aa^Fpa      , Aa^Fpa      , Aa^Fpa      , Aa^Fpa      , Ha          , Ha          , Ha          , Ha          , Aa          , Ha          , Ha          , Aa          , Aa          , Aa          , Aa          , Aa          , Ai          , Ai          , Ai          , Aa          , Aa          , Aa          
Aa          , Aa          , Aa          , Gd          , Aa^Fpa      , Aa^Fpa      , Aa^Fpa      , Aa^Fpa      , Aa^Fpa      , Aa^Fpa      , Gd          , Aa          , Aa          , Aa          , Aa          , Aa          , Aa          , Aa          , Aa          , Aa^Fpa      , Ha          , Ha          , Ha          , Ha          , Ha          , Ha          , Aa          , Aa          , Aa          , Aa          , Aa          , Ha          , Ha          , Ha          , Ha          , Gd          , Gd          , Ww          , Ai          , Gd          , Ww          , Gd          
Aa          , Aa          , Aa          , Gd          , Aa^Fpa      , Aa^Fpa      , Aa^Fpa      , Aa^Fpa      , Aa^Fpa      , Aa^Fpa      , Gd          , Aa          , Aa          , Aa          , Aa          , Aa          , Aa          , Aa          , Aa          , Ms          , Aa^Fpa      , Ha          , Ha          , Ha          , Ha          , Aa^Fpa      , Aa^Fpa      , Aa          , Aa          , Aa          , Aa          , Gd          , Gd          , Gd          , Gd          , Ha          , Ha          , Gd          , Ww          , Ww          , Ww          , Gd          
Aa          , Aa          , Aa          , Gd          , Aa^Fpa      , Aa^Fpa      , Gll^Fp      , Aa^Fpa      , Gd          , Gd          , Gd          , Aa          , Aa          , Aa          , Aa          , Aa          , Aa          , Aa          , Ms          , Ms          , Aa^Fpa      , Ha          , Ha          , Aa^Fpa      , Aa^Fpa      , Ha          , Aa^Fpa      , Aa^Fpa      , Aa          , Aa          , Hhd         , Ha          , Ha          , Ha          , Hhd         , Gd          , Ha          , Gd          , Ww          , Ww          , Ww          , Aa^Fpa      
Aa          , Aa          , Gd          , Aa^Fpa      , Aa^Fpa      , Gll^Fp      , Gd          , Gll^Fp      , Aa^Fpa      , Gd          , Gd          , Gd          , Aa          , Aa          , Aa          , Aa          , Aa          , Aa          , Aa          , Ms          , Aa^Fpa      , Aa^Fpa      , Aa^Fpa      , Aa^Fpa      , Aa^Fpa      , Aa^Fpa      , Gll^Fp      , Ww          , Ww          , Hhd         , Mm          , Mm          , Mm          , Mm          , Mm          , Hhd         , Ha          , Gd          , Gd          , Gd          , Ww          , Ww          
Aa          , Aa          , Aa          , Gd          , Gll^Fp      , Gll^Fp      , Gd          , Gd          , Aa^Fpa      , Gd          , Gd          , Aa          , Aa          , Aa          , Aa          , Aa          , Aa          , Aa          , Ai          , Ms          , Aa^Fpa      , Aa^Fpa      , Ms          , Aa^Fpa      , Aa^Fpa      , Aa^Fpa      , Gll^Fp      , Ww          , Ww          , Ww          , Ww          , Mm          , Mm          , Ms          , Mm          , Hhd         , Ha          , Aa          , Gd          , Gd          , Gd          , Ww          
Aa          , Aa          , Aa          , Gd          , Gll^Fp      , Gd          , Gll^Fp      , Aa^Fpa      , Aa^Fpa      , Aa          , Aa          , Aa          , Aa          , Aa          , Aa          , Aa          , Aa          , Aa          , Aa          , Ms          , Ms          , Ms          , Ms          , Ms          , Ms          , Aa^Fpa      , Ww          , Ww          , Ww          , Ww          , Ww          , Mm          , Mm          , Ww          , Mm          , Hhd         , Gd          , Ha          , Gd          , Aa          , Aa          , Ww          
Aa          , Aa          , Ha          , Gd          , Aa^Fpa      , Aa^Fpa      , Gll^Fp      , Aa^Fpa      , Gd          , Aa          , Aa          , Aa          , Aa          , Aa          , Aa          , Aa          , Aa          , Aa          , Ms          , Ms          , Ms          , Ms          , Ms          , Aa          , Ms          , Ms          , Aa^Fpa      , Ww          , Ww          , Ww          , Ww          , Ww          , Ww          , Ww          , Ww          , Hhd         , Gd          , Ha          , Gd          , Gd          , Gd          , Ww          
Aa          , Ha          , Ha          , Ha          , Aa^Fpa      , Aa^Fpa      , Aa^Fpa      , Gd          , Gd          , Aa          , Aa          , Aa          , Aa          , Aa          , Aa          , Aa          , Aa          , Aa          , Aa          , Ms          , Ms          , Ms          , Aa          , Aa          , Aa          , Aa          , Aa          , Ww          , Ww          , Ww          , Ww          , Ww          , Mm          , Mm          , Hhd         , Ch          , Ch          , Ch          , Gd          , Gd          , Aa          , Gd          
Aa          , Ha          , Aa          , Aa          , Gd          , Aa^Fpa      , Gd          , Aa          , Aa          , Aa          , Aa          , Aa          , Aa          , Aa          , Aa          , Ha          , Ha          , Ha          , Aa          , Ms          , Ms          , Aa          , Aa          , Aa          , Aa          , Aa          , Aa          , Ha          , Ha          , Ww          , Ww          , Ww          , Hhd         , Hhd         , Hhd         , Ch          , 2 Kh        , Ch          , Gd          , Aa          , Ha          , Gd          
Aa          , Aa          , Gd          , Aa          , Gd          , Aa^Fpa      , Aa^Fpa      , Gd          , Gd          , Gd          , Aa          , Aa          , Aa          , Aa          , Ha          , Ha          , Ms          , Ms          , Ms          , Aa          , Aa          , Aa          , Aa          , Aa          , Aa          , Aa          , Aa          , Aa          , Aa          , Aa          , Ww          , Gd          , Hhd         , Hhd         , Ch          , Ch          , Ch          , Aa^Fpa      , Gd          , Ha          , Ha          , Ha          
Ha          , Aa          , Gd          , Gd          , Aa^Fpa      , Aa^Fpa      , Aa^Fpa      , Aa^Fpa      , Aa^Fpa      , Aa^Fpa      , Aa^Fpa      , Aa          , Aa          , Ha          , Ms          , Ms          , Ms          , Ms          , Ms          , Ha          , Aa          , Aa          , Aa          , Aa          , Aa          , Aa          , Aa          , Aa          , Aa          , Aa          , Ai          , Aa          , Aa          , Aa          , Aa^Fpa      , Gd          , Gd          , Gd          , Hhd         , Ha          , Ha          , Ha          
Aa          , Aa          , Gd          , Gd          , Aa^Fpa      , Aa^Fpa      , Gll^Fp      , Gll^Fp      , Gll^Fp      , Gll^Fp      , Gll^Fp      , Gd          , Aa          , Aa          , Ms          , Ms          , Ms          , Ms          , Ms          , Ha          , Aa          , Aa          , Gd          , Gd          , Aa          , Aa          , Aa          , Aa          , Aa          , Aa          , Aa          , Ai          , Aa          , Aa          , Gd          , Gd          , Gd          , Gd          , Ha          , Ha          , Ha          , Ha          
Aa          , Aa          , Gd          , Gd          , Aa^Fpa      , Aa^Fpa      , Gll^Fp      , Gll^Fp      , Gll^Fp      , Gd          , Gll^Fp      , Aa^Fpa      , Aa          , Ha          , Ha          , Ms          , Ms          , Ms          , Ms          , Ha          , Aa          , Gd          , Gd          , Gd          , Aa          , Ww          , Aa          , Aa          , Aa          , Aa          , Aa          , Ai          , Aa          , Aa          , Aa          , Aa          , Aa          , Aa          , Aa          , Ha          , Ha          , Ha          
Aa          , Gd          , Gd          , Gd          , Gd          , Aa^Fpa      , Gll^Fp      , Gll^Fp      , Gd          , Gd          , Gll^Fp      , Aa^Fpa      , Aa          , Aa          , Ha          , Ms          , Ms          , Mm          , Ms          , Ha          , Gd          , Aa          , Aa          , Aa          , Ai          , Ww          , Gd          , Aa          , Aa          , Aa          , Ai          , Ai          , Aa          , Aa          , Aa          , Gd          , Gd          , Aa^Fpa      , Gd          , Aa          , Aa          , Aa          
