border_size=1
usage=map

Aa          , Gg          , Gg          , Gg          , Gg          , Gg          , Gll^Fp      , Wo          , Wo          , Wo          , Gll^Fp      , Gll^Fp      , Gg          , Gll^Fp      , Gll^Fp      , Wo          , Wo          , Wo          , Wo          , Wo          , Wo          , Wo          , Wo          , Gll^Fp      , Gll^Fp      , Gg^Efm      , Gg^Efm      , Gg^Efm      , Gs^Fpz      , Gs^Fpz      , Gg          , Gs^Fpz      , Gg^Efm      , Gg^Efm      , Gg^Efm      , Gg^Efm      , Rr          , Gs^Fmsz     , Gs^Fmsz     , Gs^Fmsz     , Gs^Fmsz     , Gs^Fmsz     
Gg          , Gg          , Gg          , Gg          , Gg          , Gll^Fp      , Gll^Fp      , Wo          , Wo          , Gll^Fp      , Gll^Fp      , Gs^Fp       , Gg          , Gg          , Gll^Fp      , Gll^Fp      , Wo          , Wo          , Wo          , Wo          , Wo          , Wo          , Wo          , Gll^Fp      , Gs^Fp       , Gs^Fp       , Gg^Efm      , Gg^Efm      , Gg^Efm      , Gs^Fpz      , Gs^Fpz      , Gs^Fpz      , Gs^Fpz      , Gg^Efm      , Rr          , Rr          , Gs^Fmsz     , Gs^Fmsz     , Gs^Fmsz     , Gs^Fmsz     , Gs^Fmsz     , Gs^Fmsz     
Gg          , Gg          , Gg          , Gg          , Gg          , Gg          , Gll^Fp      , Wo          , Gll^Fp      , Gll^Fp      , Gg          , Gg          , Rr          , Gg          , Gg          , Gll^Fp      , Gll^Fp      , Wo          , Wo          , Wo          , Wo          , Wo          , Wo          , Gll^Fp      , Gs^Fp       , Gg^Efm      , Gg^Efm      , Gg^Efm      , Gg^Efm      , Gs^Fpz      , Gg^Efm      , Gg^Efm      , Rr          , Rr          , Gs^Fmsz     , Gs^Fmsz     , Gs^Fmsz     , Gs^Fmsz     , Gs^Fmsz     , Gs^Fmsz     , Gs^Fmsz     , Gs^Fmsz     
Gs^Fp       , Gs^Fp       , Gg          , Gg          , Gg          , Gg          , Gll^Fp      , Gll^Fp      , Gg          , Gg          , Rr          , Rr          , Gg          , Rr          , Rr          , Gll^Fp      , Gll^Fp      , Gll^Fp      , Wo          , Wo          , Gll^Fp      , Gll^Fp      , Gll^Fp      , Gll^Fp      , Gg^Efm      , Gs^Fp       , Gg^Efm      , Gg^Efm      , Gg^Efm      , Gg^Efm      , Rr          , Rr          , Gs^Fmsz     , Gs^Fmsz     , Gs^Fmsz     , Gs^Fmsz     , Gs^Fmsz     , Gs^Fmsz     , Gs^Fmsz     , Gs^Fmsz     , Gs^Fmsz     , Gs^Fmsz     
Hh          , Gs^Fp       , Rr          , Gg          , Gg          , Gll^Fp      , Gll^Fp      , Gg          , Rr          , Rr          , Gg          , Gg          , Gg          , Gs^Fp       , Gs^Fp       , Rr          , Rr          , Gll^Fp      , Wo          , Gll^Fp      , Gll^Fp      , Gg^Efm      , Gg^Efm      , Gg^Efm      , Ds          , Gg^Efm      , Rr          , Rr          , Rr          , Rr          , Gs^Fmsz     , Gs^Fmsz     , Gs^Fmsz     , Gs^Fmsz     , Gs^Fmsz     , Gs^Fmsz     , Gs^Fmsz     , Gs^Fmsz     , Gs^Fmsz     , Gs^Fmsz     , Gs^Fmsz     , Gs^Fmsz     
Rr          , Rr          , Gs^Fp       , Rr          , Rr          , Rr          , Rr          , Rr          , Gg          , Gg          , Gg          , Hh          , Gg          , Gs^Fp       , Gs^Fp       , Gg          , Gll^Fpz     , Rr          , Rr          , Rr          , Rr          , Rr          , Aa          , Rr          , Rr          , Rr          , Gs^Fp       , Gs^Fp       , Gs^Fp       , Gg          , Gs^Fmsz     , Gs^Fmsz     , Gs^Fmsz     , Gs^Fmsz     , Gs^Fmsz     , Gg^Efm      , Gs^Fmsz     , Gs^Fmsz     , Gs^Fmsz     , Gs^Fmsz     , Gs^Fmsz     , Gs^Fmsz     
Hh          , Gs^Fp       , Gs^Fp       , Gs^Fp       , Gll^Fp      , Gll^Fp      , Gll^Fp      , Gll^Fp      , Gg          , Gg          , Hh          , Hh          , Hh          , Gg          , Gg          , Gg          , Gll^Fpz     , Gll^Fpz     , Gll^Fpz     , Gll^Fpz     , Gg^Efm      , Gg^Efm      , Aa          , Gg          , Gll^Fpz     , Gll^Fpz     , Gs^Fp       , Gg          , Gg          , Gg          , Gs^Fmsz     , Gs^Fmsz     , Gs^Fmsz     , Gs^Fmsz     , Gg^Efm      , Gg^Efm      , Gg^Efm      , Gs^Fmsz     , Gs^Fmsz     , Gs^Fmsz     , Gs^Fmsz     , Gs^Fmsz     
Hh          , Gs^Fp       , Gg          , Gg          , Gll^Fp      , Wo          , Gll^Fp      , Gll^Fp      , Gll^Fp      , Gg          , Hh          , Hh          , Gg          , Gg          , Gg          , Gg          , Gll^Fpz     , Gll^Fpz     , Gll^Fpz     , Gll^Fpz     , Gg^Efm      , Gg^Efm      , Gg^Efm      , Gll^Fpz     , Gll^Fpz     , Gll^Fpz     , Gg          , Gg          , Gg          , Gg          , Gs^Fmsz     , Gs^Fmsz     , Gs^Fmsz     , Gs^Fmsz     , Gg^Efm      , Gg^Efm      , Gg^Efm      , Gs^Fmsz     , Gs^Fmsz     , Gs^Fmsz     , Gs^Fmsz     , Gs^Fmsz     
Hh          , Gg          , Gg          , Gll^Fp      , Gll^Fp      , Wo          , Gll^Fp      , Gg          , Gg          , Gg          , Gg          , Gg          , Gg          , Gll^Fpz     , Gg          , Gll^Fpz     , Gll^Fpz     , Gll^Fpz     , Gll^Fpz     , Gll^Fpz     , Gg^Efm      , Gg^Efm      , Gg^Efm      , Gll^Fpz     , Gll^Fpz     , Gll^Fpz     , Gg^Fpz      , Gs^Fmsz     , Gs^Fmsz     , Gs^Fmsz     , Gs^Fmsz     , Gs^Fmsz     , Gs^Fmsz     , Gs^Fmsz     , Gg^Efm      , Gg^Efm      , Gll         , Gs^Fmsz     , Gs^Fmsz     , Gs^Fmsz     , Gs^Fmsz     , Ds          
Hh          , Gg          , Gg          , Gg          , Gll^Fp      , Wo          , Gll^Fp      , Gg          , Gg          , Gg          , Gg          , Gg          , Gg          , Gll^Fpz     , Gll^Fpz     , Gll^Fpz     , Gll^Fpz     , Gll^Fpz     , Gll^Fpz     , Gll^Fpz     , Gll^Fpz     , Gll^Fpz     , Gll^Fpz     , Gll^Fpz     , Gll^Fpz     , Gll^Fpz     , Gll^Fpz     , Gll^Fpz     , Gs^Fmsz     , Gs^Fmsz     , Gs^Fmsz     , Gs^Fmsz     , Gs^Fmsz     , Gs^Fmsz     , Gg^Efm      , Gs^Fmsz     , Gll         , Gs^Fmsz     , Gs^Fmsz     , Gs^Fmsz     , Gs^Fmsz     , Gs^Fmsz     
Hh          , Hh          , Gs^Fp       , Gs^Fp       , Gs^Fp       , Gll^Fp      , Wo          , Gll^Fp      , Gg          , Gg          , Gg          , Gg          , Gg          , Gll^Fpz     , Gll^Fpz     , Gll^Fpz     , Gll^Fpz     , Wo          , Wo          , Gll^Fpz     , Gg          , Gll^Fpz     , Gll^Fpz     , Gll^Fpz     , Gll^Fpz     , Gll^Fpz     , Gll^Fp      , Wo          , Wo          , Gll^Fpz     , Gll^Fpz     , Gll^Fpz     , Gs^Fmsz     , Gs^Fmsz     , Gs^Fmsz     , Gs^Fmsz     , Gll         , Gs^Fmsz     , Gs^Fmsz     , Gs^Fmsz     , Gs^Fmsz     , Gs^Fmsz     
Mm          , Hh          , Gs^Fp       , Gs^Fp       , Gs^Fp       , Gg          , Gll^Fpz     , Gll^Fpz     , Gll^Fpz     , Gll^Fpz     , Gll^Fpz     , Gll^Fpz     , Gll^Fpz     , Gll^Fpz     , Gll^Fpz     , Gll^Fpz     , Gll^Fpz     , Wo          , Wo          , Wo          , Wo          , Wo          , Wo          , Wo          , Wo          , Wo          , Wo          , Gll^Fp      , Gll^Fpz     , Gll^Fpz     , Gll^Fpz     , Gll^Fpz     , Gll^Fpz     , Gs^Fmsz     , Gs^Fmsz     , Gs^Fmsz     , Rp          , Rp          , Gs^Fmsz     , Gs^Fmsz     , Gs^Fmsz     , Gs^Fmsz     
Mm          , Hh          , Gg          , Gg          , Gs^Fp       , Gg          , Gg          , Gll^Fpz     , Gll^Fpz     , Gll^Fpz     , Wo          , Gll^Fpz     , Gll^Fpz     , Gll^Fpz     , Gll^Fpz     , Gs^Fms      , Gg^Fet      , Wo          , Wo          , Wo          , Wo          , Wo          , Wo          , Wo          , Wo          , Wo          , Wo          , Gll^Fpz     , Gll^Fpz     , Gs^Fms      , Gs^Fms      , Gll^Fpz     , Wo          , Gs^Fmsz     , Gs^Fmsz     , Gs^Fmsz     , Rp          , Rp          , Gs^Fmsz     , Gs^Fmsz     , Gs^Fmsz     , Gs^Fmsz     
Mm          , Mm          , Hh          , Gg          , Gg          , Gs^Fp       , Gg          , Gg          , Gg          , Gll^Fpz     , Gll^Fpz     , Gll^Fpz     , Gll^Fpz     , Gg^Fet      , Gg          , Gg          , Gg          , Gg          , Wo          , Wo          , Wo          , Wo          , Wo          , Wo          , Gll^Fpz     , Wo          , Wo          , Gll^Fpz     , Gll^Fpz     , Gg          , Gg          , Gll^Fpz     , Gll         , Gll         , Rp          , Rp          , Gs^Fmsz     , Gs^Fmsz     , Gs^Fmsz     , Gs^Fmsz     , Gs^Fmsz     , Gs^Fmsz     
Mm          , Mm          , Hh          , Hh          , Gg          , Gs^Fp       , Gs^Fp       , Gg          , Gg          , Gg          , Gll^Fpz     , Gs^Fms      , Gg^Fet      , Gg          , Gg          , Gg          , Gg          , Gg          , Gg^Fet      , Wo          , Wo          , Gll^Fpz     , Gll^Fpz     , Gll^Fpz     , Gll^Fpz     , Gll^Fpz     , Gll^Fpz     , Gll^Fpz     , Gll         , Gll         , Gll         , Gg          , Gs^Fmsz     , Gs^Fmsz     , Gs^Fmsz     , Gs^Fmsz     , Gs^Fmsz     , Gs^Fmsz     , Gs^Fmsz     , Gs^Fmsz     , Gs^Fmsz     , Gs^Fmsz     
Mm          , Mm          , Mm          , Mm          , Hh          , Gg          , Gs^Fp       , Gs^Fp       , Gs^Fdsz     , Gg          , Gll^Fpz     , Gs^Fms      , Re          , Gg          , Gg          , Gg          , Gg^Fet      , Gs^Fmsz     , Gll^Fpz     , Gll^Fpz     , Wo          , Gll^Fpz     , Gg          , Gg          , Gg          , Gll^Fpz     , Gs^Fp       , Gs^Fp       , Gs^Fp       , Gll         , Gll         , Gll         , Gll         , Gs^Fds      , Gs^Fmsz     , Gs^Fmsz     , Gs^Fmsz     , Gs^Fmsz     , Gs^Fmsz     , Gs^Fmsz     , Gs^Fmsz     , Gs^Fmsz     
Mm          , Mm          , Mm          , Mm          , Hh          , Gs^Fp       , Gs^Fdsz     , Gs^Fdsz     , Gs^Fpz      , Gs^Fdsz     , Re          , Re          , Gll^Fpz     , Gg^Fet      , Gs^Fms      , Gs^Fpz      , Gg^Fpz      , Gg^Fpz      , Gll^Fpz     , Gll^Fpz     , Wo          , Gll^Fpz     , Gg          , Gg          , Gg          , Gg          , Gg          , Ss          , Ss          , Gs^Fmsz     , Gs^Fmsz     , Gll         , Gs^Fmsz     , Gll         , Gs^Fmsz     , Gs^Fmsz     , Gs^Fmsz     , Gs^Fmsz     , Gs^Fmsz     , Gs^Fmsz     , Gs^Fmsz     , Gs^Fmsz     
Gll^Fpz     , Gll^Fpz     , Rp          , Hh          , Gs^Fdsz     , Gs^Fp       , Gs^Fdsz     , Gs^Fdsz     , Gll         , Re          , Gll^Fpz     , Gll^Fpz     , Gll^Fpz     , Gs^Fms      , Gs^Fpz      , Gg^Fpz      , Gg          , Gg          , Gll^Fpz     , Gll^Fpz     , Gll^Fpz     , Gll^Fpz     , Gg          , Gg          , Gg          , Gg          , Gg          , Gs^Fp       , Ss          , Gs^Fmsz     , Gs^Fmsz     , Gs^Fmsz     , Gs^Fmsz     , Gll         , Gll         , Gs^Fmsz     , Gs^Fmsz     , Gs^Fmsz     , Gs^Fmsz     , Gs^Fmsz     , Gs^Fmsz     , Gs^Fmsz     
Gll^Fpz     , Gs^Fdsz     , Rp          , Mm          , Gs^Fdsz     , Gs^Fdsz     , Gs^Fpz      , Gll         , Gs^Fpz      , Gll^Fpz     , Gs^Fdsz     , Gll^Fpz     , Gll^Fpz     , Gll^Fpz     , Gs^Fpz      , Gs^Fpz      , Gg          , Gg          , Gg          , Gg          , Gll         , Gll         , Gs^Fpz      , Gg          , Gg          , Gg          , Gg          , Gg          , Gs^Fp       , Gs^Fmsz     , Gs^Fmsz     , Wo          , Wo          , Wo          , Gll         , Gll         , Gll         , Gs^Fmsz     , Gs^Fmsz     , Gs^Fmsz     , Gs^Fmsz     , Gs^Fmsz     
Gll^Fpz     , Gll^Fpz     , Rp          , Mm          , Gs^Fdsz     , Gs^Fdsz     , Gs^Fdsz     , Gll         , Gll^Fpz     , Gll^Fpz     , Gll^Fpz     , Gll^Fpz     , Gll^Fpz     , Gll^Fpz     , Gs^Fdsz     , Gll^Fpz     , Gll^Fpz     , Gll^Fpz     , Gg          , Gg          , Gg          , Gg          , Gs^Fpz      , Gs^Fpz      , Gg          , Gg          , Gg          , Gs^Fmsz     , Gs^Fmsz     , Gs^Fmsz     , Gs^Fmsz     , Wo          , Wo          , Wo          , Wo          , Gll         , Gs^Fmsz     , Gll         , Gll         , Gs^Fmsz     , Gs^Fmsz     , Gs^Fmsz     
Gll^Fpz     , Gll^Fpz     , Rp          , Mm          , Gs^Fdsz     , Gs^Fdsz     , Gll         , Gll         , Gll^Fpz     , Gll^Fpz     , Gll^Fpz     , Gll^Fpz     , Gs^Fdsz     , Gll^Fpz     , Gll^Fpz     , Gs^Fdsz     , Gll^Fpz     , Gll^Fpz     , Gll^Fpz     , Gll^Fpz     , Gs^Fpz      , Gs^Fpz      , Gs^Fpz      , Gs^Fmsz     , Gs^Fmsz     , Gg          , Gs^Fmsz     , Gs^Fmsz     , Gs^Fmsz     , Gs^Fmsz     , Wo          , Wo          , Wo          , Wo          , Wo          , Gs^Fmsz     , Gs^Fmsz     , Gs^Fmsz     , Gll         , Gs^Fmsz     , Gs^Fmsz     , Gs^Fmsz     
Gll^Fpz     , Gll^Fpz     , Rp          , Gs^Fdsz     , Gll         , Gll         , Gll^Fpz     , Gll^Fpz     , Gll^Fpz     , Gll^Fpz     , Gll^Fpz     , Gll^Fpz     , Gll^Fpz     , Gll^Fpz     , Gs^Fdsz     , Gs^Fdsz     , Gs^Fpz      , Gll^Fpz     , Gll^Fpz     , Gll^Fpz     , Ss          , Ss          , Ss          , Gs^Fmsz     , Gs^Fp       , Gs^Fmsz     , Gs^Fmsz     , Gs^Fmsz     , Gs^Fmsz     , Wo          , Wo          , Wo          , Wo          , Wo          , Wo          , Gs^Fmsz     , Gs^Fmsz     , Gs^Fmsz     , Gll         , Gs^Fpz      , Gs^Fpz      , Gs^Fpz      
Gll^Fpz     , Gll^Fpz     , Gll         , Gll         , Gll^Fpz     , Gll^Fpz     , Gll^Fpz     , Gll^Fpz     , Gll^Fpz     , Gs^Fdsz     , Gll^Fpz     , Gll^Fpz     , Gs^Fdsz     , Gs^Fp       , Rd          , Gll         , Gll         , Gs^Fpz      , Gll^Fpz     , Gll^Fpz     , Gll^Fpz     , Gll^Fpz     , Gll^Fpz     , Gs^Fp       , Gs^Fp       , Gs^Fmsz     , Gs^Fmsz     , Gs^Fmsz     , Gs^Fmsz     , Gs^Fmsz     , Wo          , Wo          , Wo          , Wo          , Wo          , Wo          , Gs^Fmsz     , Gs^Fmsz     , Gll         , Gs^Fpz      , Gs^Fpz      , Gs^Fpz      
Gll         , Gll         , Gll^Fpz     , Gll^Fpz     , Gll^Fpz     , Gll^Fpz     , Gll^Fpz     , Gll^Fpz     , Gll^Fpz     , Gs^Fdsz     , Gll^Fpz     , Gs^Fdsz     , Rd          , Rd          , Gs^Fdsz     , Gs^Fdsz     , Gs^Fdsz     , Gll         , Gll         , Gll^Fpz     , Gll^Fpz     , Gll^Fpz     , Gll^Fpz     , Gll^Fpz     , Gll^Fpz     , Gs^Fds      , Gs^Fp       , Gs^Fds      , Gs^Fmsz     , Gs^Fmsz     , Wo          , Wo          , Wo          , Wo          , Wo          , Gs^Fmsz     , Gs^Fmsz     , Gs^Fmsz     , Gll^Fpz     , Gs^Fms      , Gs^Fpz      , Gs^Fpz      
Gll         , Gll         , Gll         , Gll^Fpz     , Gll^Fpz     , Gs^Fdsz     , Gll^Fpz     , Gll^Fpz     , Gll^Fpz     , Gll^Fpz     , Gll         , Gll         , Gs^Fp       , Gs^Fdsz     , Gs^Fdsz     , Gs^Fdsz     , Gs^Fdsz     , Gs^Fdsz     , Gg          , Gll         , Wo          , Wo          , Wo          , Gll^Fpz     , Gll^Fpz     , Gs^Fds      , Gs^Fds      , Gs^Fds      , Gs^Fmsz     , Gs^Fmsz     , Gs^Fmsz     , Gs^Fmsz     , Gll         , Gll         , Wo          , Gs^Fmsz     , Gs^Fmsz     , Gs^Fmsz     , Gll^Fpz     , Gll^Fpz     , Gs^Fmsz     , Gs^Fpz      
Gll         , Gll         , Gll         , Gll         , Gs^Fdsz     , Gll^Fpz     , Gll^Fpz     , Gll^Fpz     , Gll         , Gll^Fpz     , Gll         , Gs^Fdsz     , Gs^Fdsz     , Gs^Fdsz     , Gs^Fdsz     , Gs^Fdsz     , Gs^Fdsz     , Gs^Fdsz     , Gs^Fdsz     , Gg          , Gg          , Gg          , Wo          , Gll^Fpz     , Gll^Fpz     , Gs^Fds      , Gs^Fds      , Gs^Fds      , Gs^Fds      , Gs^Fpz      , Gs^Fmsz     , Gs^Fds      , Gll         , Gs^Fpz      , Gs^Fmsz     , Gs^Fmsz     , Gs^Fmsz     , Gs^Fmsz     , Gll^Fpz     , Gll^Fpz     , Gs^Fmsz     , Gs^Fpz      
Gll         , Gll         , Gll         , Gll         , Gll         , Gll^Fpz     , Gll         , Gll         , Gll         , Gll         , Gll^Fpz     , Gll^Fpz     , Gs^Fdsz     , Gs^Fdsz     , Gs^Fdsz     , Gs^Fdsz     , Gs^Fdsz     , Gs^Fdsz     , Gs^Fp       , Gg          , Gg          , Wo          , Wo          , Gll^Fpz     , Gs^Fds      , Gs^Fds      , Gs^Fds      , Gs^Fds      , Gs^Fds      , Gs^Fpz      , Gs^Fpz      , Gs^Fds      , Gll         , Gs^Fpz      , Gs^Fpz      , Gs^Fpz      , Gs^Fpz      , Gs^Fmsz     , Gll^Fpz     , Gll^Fpz     , Gs^Fmsz     , Gs^Fmsz     
Gs^Fdsz     , Gll         , Gs^Fdsz     , Gs^Fdsz     , Gs^Fdsz     , Gll         , Gll^Fpz     , Gll         , Gll^Fpz     , Gll^Fpz     , Gll^Fpz     , Gll^Fpz     , Gs^Fdsz     , Gs^Fdsz     , Gs^Fdsz     , Gs^Fdsz     , Gs^Fdsz     , Gs^Fp       , Gs^Fdsz     , Gs^Fdsz     , Gll^Fpz     , Gll^Fpz     , Gll^Fpz     , Gll^Fpz     , Gs^Fms      , Gs^Fds      , Gs^Fds      , Gs^Fpz      , Gs^Fpz      , Gs^Fpz      , Gs^Fpz      , Gll         , Gll         , Gs^Fpz      , Gs^Fpz      , Gs^Fpz      , Gs^Fpz      , Gs^Fpz      , Gll^Fpz     , Gll^Fpz     , Gs^Fmsz     , Gs^Fmsz     
Gs^Fdsz     , Gll         , Gs^Fdsz     , Gs^Fdsz     , Gll^Fpz     , Gll^Fpz     , Gll^Fpz     , Gll^Fpz     , Gll^Fpz     , Gll^Fpz     , Gs^Fdsz     , Gs^Fdsz     , Gs^Fdsz     , Gs^Fdsz     , Gs^Fdsz     , Gs^Fdsz     , Gs^Fdsz     , Gs^Fdsz     , Gs^Fdsz     , Gs^Fdsz     , Gll^Fpz     , Gll^Fpz     , Gll^Fpz     , Gs^Fms      , Gs^Fms      , Gs^Fds      , Gs^Fds      , Gs^Fpz      , Gs^Fpz      , Gs^Fpz      , Gs^Fpz      , Gll         , Gll         , Gll         , Gll         , Gll         , Gll         , Gll^Fpz     , Gs^Fmsz     , Gs^Fmsz     , Gs^Fmsz     , Gs^Fmsz     
Gs^Fdsz     , Gll         , Gll         , Gs^Fdsz     , Gll^Fpz     , Gll^Fpz     , Gll^Fpz     , Gs^Fdsz     , Gs^Fdsz     , Gs^Fdsz     , Gs^Fdsz     , Gs^Fdsz     , Gs^Fdsz     , Gs^Fdsz     , Gs^Fdsz     , Gs^Fdsz     , Gs^Fdsz     , Gs^Fdsz     , Gs^Fdsz     , Gs^Fdsz     , Gs^Fdsz     , Gs^Fdsz     , Gll         , Gs^Fms      , Gll         , Gs^Fds      , Gs^Fds      , Gs^Fpz      , Gs^Fpz      , Gs^Fpz      , Gll         , Gll         , Gll         , Gll         , Gs^Fpz      , Gll         , Gs^Fpz      , Gs^Fpz      , Gs^Fmsz     , Gs^Fmsz     , Gs^Fmsz     , Gs^Fmsz     
Gs^Fdsz     , Gs^Fdsz     , Gll         , Gll         , Gll         , Gll^Fpz     , Gll^Fpz     , Gs^Fdsz     , Gs^Fdsz     , Gs^Fpz      , Gs^Fdsz     , Gs^Fp       , Gs^Fms      , Gs^Fdsz     , Gs^Fdsz     , Gs^Fdsz     , Gs^Fms      , Gs^Fdsz     , Gs^Fdsz     , Gs^Fdsz     , Gs^Fdsz     , Gs^Fdsz     , Gll         , Gll         , Gll         , Gll         , Gll         , Gs^Fds      , Gll         , Gll         , Gll         , Gll         , Gll         , Gll         , Gll         , Gs^Fpz      , Gs^Fpz      , Gs^Fpz      , Gs^Fmsz     , Gs^Fmsz     , Gs^Fmsz     , Gs^Fmsz     
Gs^Fdsz     , Gs^Fdsz     , Gs^Fdsz     , Gll         , Gll         , Gll         , Gll         , Gs^Fpz      , Gs^Fdsz     , Gs^Fpz      , Gs^Fpz      , Gs^Fdsz     , Gs^Fdsz     , Gs^Fdsz     , Gs^Fdsz     , Gs^Fdsz     , Gs^Fdsz     , Gs^Fdsz     , Gs^Fdsz     , Gs^Fdsz     , Gs^Fdsz     , Gs^Fdsz     , Rrc         , Gll         , Gs^Fdsz     , Gll         , Gs^Fms      , Gll         , Gs^Fdsz     , Gs^Fdsz     , Gs^Fdsz     , Gll         , Gll         , Gll         , Gll         , Gll         , Gll         , Gs^Fmsz     , Gs^Fpz      , Gs^Fmsz     , Gs^Fmsz     , Gs^Fmsz     
Gs^Fdsz     , Gs^Fdsz     , Gs^Fdsz     , Gll^Fpz     , Gll^Fpz     , Gll         , Gll         , Gs^Fpz      , Gs^Fdsz     , Gs^Fpz      , Gs^Fpz      , Gs^Fdsz     , Gs^Fdsz     , Gs^Fms      , Gs^Fdsz     , Gs^Fdsz     , Gs^Fdsz     , Gs^Fdsz     , Gs^Fdsz     , Gs^Fdsz     , Gs^Fdsz     , Gs^Fdsz     , Rrc         , Gs^Fdsz     , Gs^Fdsz     , Gs^Fdsz     , Gs^Fdsz     , Gs^Fdsz     , Gs^Fdsz     , Gs^Fdsz     , Gs^Fdsz     , Gs^Fdsz     , Hh^Fmsz     , Gll         , Gs^Fpz      , Gs^Fpz      , Gll         , Gs^Fmsz     , Gs^Fmsz     , Gs^Fpz      , Gs^Fmsz     , Gs^Fmsz     
Gs^Fdsz     , Gs^Fdsz     , Gll^Fpz     , Gll^Fpz     , Gll^Fpz     , Gll         , Gll         , Gs^Fpz      , Gll         , Gs^Fdsz     , Gs^Fdsz     , Gs^Fdsz     , Gs^Fdsz     , Gs^Fdsz     , Gs^Fdsz     , Gs^Fpz      , Gs^Fpz      , Gs^Fdsz     , Gs^Fdsz     , Gs^Fdsz     , Rrc         , Rrc         , Gs^Fpz      , Gs^Fdsz     , Gs^Fdsz     , Gs^Fdsz     , Gs^Fdsz     , Gs^Fdsz     , Gs^Fdsz     , Gs^Fdsz     , Gs^Fdsz     , Gs^Fpz      , Gs^Fpz      , Gs^Fpz      , Gs^Fpz      , Gs^Fmsz     , Gs^Fmsz     , Gll         , Gs^Fpz      , Gs^Fmsz     , Gs^Fmsz     , Gs^Fmsz     
Gs^Fdsz     , Gll^Fpz     , Gll^Fpz     , Gll^Fpz     , Wo          , Wo          , Gll^Fp      , Gll         , Gll         , Gll         , Gll         , Gll^Fpz     , Gll^Fpz     , Gs^Fdsz     , Gs^Fdsz     , Ss          , Gs^Fpz      , Gs^Fpz      , Gs^Fdsz     , Gs^Fdsz     , Gll         , Gs^Fpz      , Gs^Fds      , Gs^Fpz      , Gs^Fpz      , Gs^Fdsz     , Gs^Fdsz     , Gs^Fdsz     , Gs^Fdsz     , Gs^Fdsz     , Gs^Fdsz     , Gs^Fdsz     , Gs^Fpz      , Gs^Fmsz     , Gs^Fmsz     , Gs^Fmsz     , Gs^Fmsz     , Gll         , Gll         , Gs^Fmsz     , Gs^Fmsz     , Gs^Fmsz     
Gll^Fpz     , Gll^Fpz     , Wo          , Wo          , Wo          , Wo          , Wo          , Wo          , Wo          , Wo          , Wo          , Gll         , Gll         , Gs^Fms      , Gll         , Gs^Fdsz     , Iwr         , Gs^Fpz      , Gs^Fpz      , Gs^Fpz      , Gll         , Gll         , Gll         , Gg          , Gs^Fpz      , Gs^Fdsz     , Gs^Fdsz     , Gs^Fdsz     , Ww          , Gs^Fdsz     , Gs^Fmsz     , Gs^Fmsz     , Gs^Fmsz     , Gs^Fmsz     , Gs^Fmsz     , Gs^Fmsz     , Gs^Fmsz     , Gs^Fmsz     , Wwg         , Wwg         , Wo          , Wo          
Wo          , Wo          , Wo          , Wo          , Wo          , Gll^Fpz     , Gll^Fpz     , Gll^Fpz     , Gll^Fpz     , Gll^Fpz     , Wo          , Gll^Fpz     , Gll^Fpz     , Gll         , Gll         , Iwr         , Gs^Fpz      , Iwr         , Gll         , Gll         , Gg          , Hh          , Hh          , Gll         , Gll         , Gs^Fdsz     , Ww          , Ww          , Ww          , Gs^Fmsz     , Gs^Fmsz     , Gs^Fmsz     , Gs^Fmsz     , Gs^Fmsz     , Gs^Fmsz     , Gs^Fmsz     , Gs^Fmsz     , Wwg         , Gs^Fms      , Gll         , Gll         , Wo          
Wo          , Wo          , Gll^Fpz     , Wo          , Gll^Fpz     , Gll^Fpz     , Gll^Fpz     , Gll^Fpz     , Gll^Fpz     , Gll^Fpz     , Gll^Fpz     , Gll^Fpz     , Gs^Fmsz     , Gs^Fmsz     , Gs^Fmsz     , Gs^Fdsz     , Gs^Fpz      , Hh          , Hh          , Ww          , Ww          , Ww          , Ww          , Gll         , Ww          , Ww          , Gll^Fp      , Gll^Fp      , Ww          , Wo          , Wo          , Wo          , Wo          , Wo          , Wo          , Wo          , Wo          , Wo          , Gs^Fms      , Gll         , Gll         , Wo          
Wo          , Wo          , Wo          , Gll^Fpz     , Gg          , Gg          , Gg          , Gg          , Gg          , Gg          , Gll^Fpz     , Gg          , Gg          , Gg          , Gg          , Hh          , Hh          , Hh          , Mm          , Hh          , Ww          , Ww          , Ww          , Ww          , Gs^Fp       , Gll         , Gll         , Gll^Fp      , Gll^Fp      , Wo          , Wo          , Wo          , Wo          , Wo          , Wo          , Wo          , Wo          , Wo          , Gs^Fms      , Gs^Fms      , Gll         , Wo          
Wo          , Wo          , Wo          , Gll^Fp      , Gg          , Gg          , Gg          , Gg          , Gg          , Gg          , Gll^Fpz     , Gg          , Gg          , Gg          , Hh          , Mm          , Mm          , Mm          , Mm          , Ww          , Ww          , Ww          , Ww          , Ww          , Gs^Fp       , Gs^Fp       , Gll         , Gll         , Gll^Fp      , Wo          , Wo          , Wo          , Wo          , Wo          , Wwg         , Wwg         , Wwg         , Wo          , Gs^Fms      , Gs^Fms      , Gll         , Gs^Fms      
Wo          , Wo          , Wo          , Gll^Fp      , Gg          , Gg          , Gg          , Gg          , Gs^Fpz      , Gs^Fpz      , Gll^Fpz     , Gg          , Gg          , Hh          , Mm          , Mm          , Mm          , Mm          , Mm          , Ww          , Ww          , Ww          , Ww          , Ww          , Gs^Fp       , Gs^Fp       , Gs^Fp       , Gll         , Gll         , Gll^Fp      , Gll         , Gll         , Gll         , Gll         , Wwg         , Wwg         , Wo          , Gll         , Gll         , Gs^Fms      , Gll         , Gg          
Wo          , Wo          , Wo          , Gll^Fpz     , Gll^Fpz     , Gs^Fpz      , Gg          , Gs^Fpz      , Gs^Fpz      , Gs^Fpz      , Gg          , Gs^Fpz      , Gs^Fpz      , Hh          , Mm          , Mm          , Mm          , Mm          , Mm          , Ww          , Ww          , Ww          , Ww          , Ww          , Ww          , Gs^Fp       , Gs^Fp       , Gs^Fp       , Gll^Fp      , Gll         , Gll^Fp      , Gll^Fp      , Gll^Fp      , Gll^Fp      , Gll^Fp      , Wo          , Wo          , Gs^Fms      , Gs^Fms      , Gll         , Gg          , Gs^Fp       
