border_size=1
usage=map

Wo          , Wo          , Wo          , Wo          , Wo          , Wo          , Wo          , Wo          , Wo          , Wo          , Wo          , Wo          , Wo          , Wo          , Ww          , Ww          , Dd          , Dd          , Dd          , Dd          , Dd          , Dd          , Gs          , Gs          , Gs          , Gs^Ft       , Dd          , Dd          , Dd          , Gs          , Hd          , Gs          , Hd          , Hd          , Hd          , Dd          , Dd          , Dd          , Dd          , Dd          , Dd          , Dd          
Wo          , Wo          , Wo          , Wo          , Wo          , Wo          , Wo          , Wo          , Wo          , Wo          , Wo          , Wo          , Wo          , Wo          , Ww          , Ww          , Dd          , Dd          , Dd          , Dd          , Dd          , Dd          , Gs^Ft       , Gs^Ft       , Gs^Ft       , Dd          , Dd          , Dd          , Dd          , Gs^Ft       , Gs          , Gs          , Hd          , Hd          , Hd          , Gs^Ft       , Dd          , Dd          , Dd          , Dd          , Dd          , Dd          
Wo          , Wo          , Wo          , Wo          , Wo          , Wo          , Wo          , Wo          , Wo          , Wo          , Wo          , Wo          , Wo          , Ww          , Ww          , Ww          , Gs          , Gs^Ft       , Hd          , Hd          , Hd          , Dd          , Gs^Ft       , Dd          , Dd          , Dd          , Dd          , Dd          , Dd          , Dd          , Gs^Ft       , Gs          , Hd          , Hd          , Hd          , Gs^Ft       , Dd          , Dd          , Dd          , Dd          , Dd          , Rd          
Wo          , Wo          , Wo          , Wo          , Wo          , Wo          , Wo          , Wo          , Wo          , Wo          , Wo          , Wo          , Ww          , Gs          , Gs          , Ww          , Hd          , Hd          , Hd          , Hd          , Hd          , Hd          , Dd          , Dd          , Dd          , Dd          , Dd          , Dd          , Dd          , Hd          , Gs          , Gs          , Gs          , Gs          , Hd          , Hd          , Gs^Ft       , Dd          , Dd          , Dd          , Rd          , Rd          
Wo          , Wo          , Wo          , Wo          , Wo          , Wo          , Wo          , Wo          , Wo          , Wo          , Wo          , Ww          , Gs          , Ww          , Hd          , Ww          , Md          , Md          , Md          , Hd          , Hd          , Hd          , Dd          , Dd          , Dd          , Dd          , Hd          , Hd          , Hd          , Dd          , Dd          , Gs          , Gs          , Gs          , Gs          , Ch          , 1 Kh        , Dd          , Rd          , Rd          , Dd          , Dd          
Wo          , Wo          , Wo          , Wo          , Wo          , Wo          , Wo          , Wo          , Wo          , Wo          , Ww          , Gs          , Gs          , Ww          , Ww          , Ww          , Md          , Md          , Md          , Md          , Hd          , Hd          , Hd          , Dd          , Dd          , Gs^Ft       , Hd          , Md          , Hd          , Hd          , Hd          , Gs          , Gs          , Gs          , Re          , Rd          , Rd          , Rd          , Dd          , Dd          , Dd          , Gs          
Wo          , Wo          , Wo          , Wo          , Wo          , Wo          , Wo          , Wo          , Wo          , Wo          , Ww          , Gs          , Gs^Ft       , Ww          , Ww          , Ww          , Ww          , Ww          , Md          , Md          , Md          , Hd          , Hd          , Gs^Ft       , Gs^Ft       , Gs^Ft       , Hd          , Hd          , Md          , Md          , Hd          , Gs          , Gs          , Re          , Gs^Ft       , Rd          , Dd          , Dd          , Dd          , Dd          , Dd          , Dd          
Wo          , Wo          , Wo          , Wo          , Wo          , Wo          , Wo          , Wo          , Ww          , Ww          , Ww          , Gs          , Dd          , Hd          , Ww          , Ww          , Ww          , Md          , Md          , Md          , Md          , Hd          , Dd          , Gs^Ft       , Gs          , Gs^Ft       , Gs          , Hd          , Hd          , Hd          , Hd          , Gs          , Re          , Re          , Dd          , Gs^Ft       , Gs^Ft       , Dd          , Dd          , Dd          , Dd          , Dd          
Wo          , Wo          , Wo          , Wo          , Wo          , Wo          , Wo          , Wo          , Ww          , Ww          , Dd          , Gs^Ft       , Gs^Ft       , Hd          , Ww          , Ww          , Ww          , Md          , Md          , Md          , Md          , Hd          , Dd          , Dd          , Dd          , Gs^Ft       , Gs^Ft       , Gs          , Hd          , Hd          , Hd          , Gs          , Re          , Rd          , Gs^Ft       , Gs          , Gs          , Gs          , Gs^Ft       , Dd          , Dd          , Dd          
Wo          , Wo          , Wo          , Wo          , Wo          , Wo          , Wo          , Ww          , Ww          , Ww          , Dd          , Gs^Ft       , Gs          , Hd          , Ww          , Ww          , Md          , Md          , Md          , Md          , Hd          , Dd          , Dd          , Dd          , Dd          , Dd          , Gs^Ft       , Gs          , Gs          , Gs          , Gs          , Re          , Rd          , Dd          , Dd          , Gs^Ft       , Gs          , Gs          , Gs          , Gs          , Gs^Ft       , Dd          
Wo          , Wo          , Wo          , Wo          , Wo          , Wo          , Wo          , Ww          , Ww          , Ww          , Dd          , Gs^Ft       , Gs          , Hd          , Md          , Md          , Md          , Md          , Md          , Hd          , Hd          , Dd          , Gs^Ft       , Gs^Ft       , Dd          , Dd          , Gs^Ft       , Gs          , Gs          , Gs          , Gs          , Re          , Rd          , Dd          , Dd          , Dd          , Dd          , Gs          , Dd          , Ww          , Dd          , Gs^Ft       
Wo          , Wo          , Wo          , Wo          , Wo          , Wo          , Wo          , Ww          , Ww          , Dd          , Gs^Ft       , Gs          , Gs          , Hd          , Hd          , Hd          , Md          , Md          , Hd          , Hd          , Hd          , Dd          , Dd          , Dd          , Gs^Ft       , Ww          , Dd          , Gs^Ft       , Gs          , Gs          , Gs          , Re          , Dd          , Dd          , Dd          , Dd          , Dd          , Ww          , Ww          , Ww          , Ww          , Gs          
Wo          , Wo          , Wo          , Wo          , Wo          , Wo          , Wo          , Ww          , Dd          , Gs^Ft       , Gs          , Gs          , Hd          , Hd          , Hd          , Hd          , Hd          , Hd          , Hd          , Hd          , Hd          , Hd          , Dd          , Dd          , Gs          , Gs^Ft       , Dd          , Dd          , Dd          , Dd          , Rd          , Re          , Dd          , Dd          , Dd          , Dd          , Dd          , Ww          , Ww          , Ww          , Ww          , Ww          
Wo          , Wo          , Wo          , Wo          , Wo          , Wo          , Ww          , Dd          , Dd          , Gs          , Gs          , Gs          , Hd          , Hd          , Gs          , Gs          , Hd          , Hd          , Hd          , Hd          , Hd          , Hd          , Dd          , Dd          , Gs^Ft       , Dd          , Dd          , Dd          , Rd          , Rd          , Rd          , Rd          , Hd          , Hd          , Dd          , Dd          , Dd          , Dd          , Ww          , Ww          , Gs^Ft       , Dd          
Wo          , Wo          , Wo          , Wo          , Wo          , Wo          , Ww          , Dd          , Dd          , Hd          , Hd          , Hd          , Hd          , Hd          , Gs          , Gs          , Gs          , Gs          , Hd          , Gs          , Hd          , Hd          , Hd          , Dd          , Dd          , Dd          , Dd          , Rd          , Dd          , Dd          , Rd          , Hd          , Hd          , Hd          , Dd          , Dd          , Dd          , Gs^Ft       , Dd          , Gs          , Dd          , Dd          
Wo          , Wo          , Wo          , Wo          , Wo          , Wo          , Ww          , Dd          , Gs^Ft       , Hd          , Md          , Hd          , Hd          , Gs          , Gs          , Gs          , Gs          , Gs          , Gs          , Gs          , Gs          , Gs          , Gs^Ft       , Dd          , Dd          , Dd          , Rd          , Rd          , Dd          , Rd          , Hd          , Hd          , Hd          , Hd          , Dd          , Dd          , Dd          , Gs          , Gs          , Gs          , Gs^Ft       , Dd          
Wo          , Wo          , Wo          , Wo          , Wo          , Wo          , Ww          , Gs^Ft       , Gs          , Hd          , Hd          , Hd          , Hd          , Gs          , Gs          , Gs          , Gs          , Gs          , Gs          , Gs          , Gs          , Dd          , Dd          , Dd          , Rd          , Rd          , Dd          , Dd          , Rd          , Rd          , Dd          , Hd          , Hd          , Hd          , Dd          , Dd          , Dd          , Gs          , Gs          , Gs          , Gs^Ft       , Gs^Ft       
Wo          , Wo          , Wo          , Wo          , Wo          , Wo          , Ww          , Gs^Ft       , Gs          , Hd          , Hd          , Hd          , Hd          , Hd          , Gs          , Gs          , Gs          , Gs          , Gs          , Gs          , Dd          , Dd          , Rd          , Rd          , Dd          , Dd          , Rd          , Rd          , Dd          , Hd          , Dd          , Hd          , Hd          , Hd          , Dd          , Dd          , Dd          , Gs          , Gs          , Gs          , Gs          , Gs          
Wo          , Wo          , Wo          , Wo          , Wo          , Ww          , Ww          , Gs^Ft       , Gs          , Hd          , Hd          , Hd          , Hd          , Gs          , Gs          , Gs          , Gs^Ft       , Dd          , Dd          , Dd          , Rd          , Rd          , Dd          , Dd          , Rd          , Rd          , Dd          , Gs^Ft       , Dd          , Hd          , Hd          , Hd          , Hd          , Hd          , Hd          , Dd          , Dd          , Dd          , Gs          , Gs^Ft       , Gs          , Hd          
Wo          , Wo          , Wo          , Wo          , Wo          , Ww          , Ww          , Dd          , Dd          , Hd          , Hd          , Hd          , Gs          , Gs          , Gs          , Gs^Ft       , Dd          , Dd          , Dd          , Dd          , Rd          , Dd          , Dd          , Dd          , Rd          , Dd          , Gs^Ft       , Gs          , Dd          , Hd          , Md          , Hd          , Hd          , Hd          , Hd          , Dd          , Dd          , Dd          , Dd          , Dd          , Gs^Ft       , Gs          
Wo          , Wo          , Wo          , Wo          , Wo          , Ww          , Ww          , Dd          , Dd          , Gs^Ft       , Gs          , Gs          , Gs          , Gs          , Gs          , Gs^Ft       , Dd          , Dd          , Dd          , Dd          , Rd          , Dd          , Dd          , Rd          , Dd          , Dd          , Dd          , Gs^Ft       , Hd          , Md          , Md          , Md^Xm       , Hd          , Hd          , Hd          , Dd          , Dd          , Dd          , Dd          , Dd          , Dd          , Dd          
Wo          , Wo          , Wo          , Wo          , Wo          , Ww          , Ww          , Dd          , Dd          , Gs^Ft       , Gs          , Gs          , Gs          , Gs          , Gs          , Gs^Ft       , Dd          , Dd          , Ds          , Dd          , Rd          , Dd          , Rd          , Rd          , Dd          , Dd          , Dd          , Hd          , Hd          , Md          , Md^Xm       , Md^Xm       , Md^Xm       , Hd          , Hd          , Hd          , Dd          , Dd          , Dd          , Dd          , Dd          , Dd          
Wo          , Wo          , Wo          , Wo          , Wo          , Ww          , Ww          , Dd          , Dd          , Gs          , Gs          , Gs          , Gs          , Gs          , Gs^Ft       , Gs^Ft       , Dd          , Ds          , Ds          , Dd          , Rd          , Dd          , Rd          , Ds          , Dd          , Dd          , Dd          , Hd          , Md          , Md          , Md^Xm       , Md^Xm       , Hd          , Hd          , Hd          , Dd          , Dd          , Dd          , Dd          , Dd          , Gs          , Dd          
Wo          , Wo          , Wo          , Wo          , Wo          , Ww          , Ww          , Ww          , Dd          , Gs^Ft       , Gs          , Gs          , Gs          , Dd          , Dd          , Dd          , Dd          , Dd          , Dd          , Dd          , Rd          , Rd          , Ds          , Ds          , Dd          , Dd          , Hd          , Hd          , Md          , Md          , Md^Xm       , Md^Xm       , Md^Xm       , Hd          , Hd          , Dd          , Gs^Ft       , Dd          , Dd          , Dd          , Gs          , Gs          
Wo          , Wo          , Wo          , Wo          , Wo          , Ww          , Ww          , Ww          , Dd          , Gs^Ft       , Gs^Ft       , Dd          , Dd          , Dd          , Dd          , Dd          , Dd          , Dd          , Dd          , Dd          , Rd          , Rd          , Ds          , Ds          , Dd          , Dd          , Hd          , Md          , Md^Xm       , Md^Xm       , Md^Xm       , Md          , Md          , Md          , Hd          , Dd          , Gs^Ft       , Gs^Ft       , Dd          , Dd          , Dd          , Gs          
Wo          , Wo          , Wo          , Wo          , Wo          , Wo          , Ww          , Ww          , Ww          , Gs^Ft       , Dd          , Dd          , Dd          , Dd          , Dd          , Dd          , Dd          , Dd          , Ds          , Ds          , Re          , Re          , Ds          , Dd          , Dd          , Hd          , Md          , Md          , Md^Xm       , Md^Xm       , Md          , Md          , Md          , Md          , Dd          , Dd          , Gs          , Gs          , Gs^Ft       , Dd          , Dd          , Dd          
Wo          , Wo          , Wo          , Wo          , Wo          , Wo          , Wo          , Ww          , Ww          , Ww          , Dd          , Dd          , Dd          , Dd          , Dd          , Dd          , Dd          , Gs^Ft       , Ds          , Re          , Ds          , Ds          , Ds          , Ds          , Gs^Ft       , Md          , Md          , Md^Xm       , Md          , Md          , Md          , Md          , Dd          , Dd          , Dd          , Dd          , Gs          , Gs          , Gs          , Gs          , Dd          , Dd          
Wo          , Wo          , Wo          , Wo          , Wo          , Wo          , Wo          , Wo          , Ww          , Ww          , Dd          , Dd          , Dd          , Dd          , Dd          , Dd          , Dd          , Ds          , Re          , Re          , Ds          , Ds          , Ds          , Ds          , Ds          , Md          , Md          , Md          , Hd          , Hd          , Dd          , Dd          , Dd          , Dd          , Dd          , Dd          , Gs          , Gs          , Hd          , Gs          , Dd          , Hd          
Wo          , Wo          , Wo          , Wo          , Wo          , Wo          , Wo          , Wo          , Wo          , Ww          , Ww          , Dd          , Dd          , Dd          , Dd          , Dd          , Dd          , Dd          , Dd          , Ds          , Ds          , Ds          , Ds          , Ds          , Ds          , Ds          , Ds          , Ds          , Dd          , Dd          , Dd          , Dd          , Dd          , Dd          , Dd          , Dd          , Gs          , Hd          , Hd          , Hd          , Gs          , Hd          
Wo          , Wo          , Wo          , Wo          , Wo          , Wo          , Wo          , Wo          , Wo          , Wo          , Wo          , Ww          , Dd          , Dd          , Dd          , Rd          , Dd          , Dd          , Dd          , Dd          , Gs^Ft       , Ds          , Ds          , Ds          , Ds          , Ds          , Ds          , Dd          , Dd          , Dd          , Dd          , Dd          , Gs^Ft       , Dd          , Dd          , Gs^Ft       , Hd          , Hd          , Hd          , Hd          , Hd          , Hd          
Wo          , Wo          , Wo          , Wo          , Wo          , Wo          , Wo          , Wo          , Wo          , Wo          , Wo          , Ww          , Gs          , Gs          , Gs          , Re          , Gs          , Dd          , Dd          , Dd          , Dd          , Dd          , Ds          , Ds          , Ds          , Ds          , Ds          , Dd          , Dd          , Dd          , Dd          , Dd          , Dd          , Dd          , Hd          , Hd          , Hd          , Hd          , Hd          , Md          , Hd          , Hd          
Wo          , Wo          , Wo          , Wo          , Wo          , Wo          , Wo          , Wo          , Wo          , Wo          , Ww          , Ww          , Gs          , Gs          , Re          , Re          , Dd          , Dd          , Dd          , Dd          , Dd          , Dd          , Ds          , Ds          , Ds          , Ds          , Ds          , Dd          , Ww          , Dd          , Hd          , Hd          , Hd          , Hd          , Hd          , Hd          , Md          , Hd          , Hd          , Hd          , Hd          , Dd          
Wo          , Wo          , Wo          , Wo          , Wo          , Wo          , Wo          , Wo          , Wo          , Ww          , Ww          , Dd          , Re          , Re          , Hd          , Dd          , Dd          , Dd          , Dd          , Dd          , Dd          , Dd          , Ds          , Ds          , Ds          , Ds          , Ww          , Ww          , Ww          , Ww          , Md          , Md          , Md          , Md          , Md          , Md          , Ww          , Ww          , Hd          , Gs^Ft       , Dd          , Dd          
Wo          , Wo          , Wo          , Wo          , Wo          , Wo          , Wo          , Wo          , Ww          , Ww          , Ww          , Gs          , Re          , Hd          , Hd          , Dd          , Md          , Ww          , Ww          , Hd          , Hd          , Gs^Ft       , Ds          , Ds          , Ds          , Hd          , Ww          , Ww          , Ww          , Ww          , Md          , Md          , Md          , Md          , Md          , Ww          , Ww          , Ww          , Ww          , Dd          , Dd          , Dd          
Wo          , Wo          , Wo          , Wo          , Wo          , Wo          , Wo          , Ww          , Ww          , Ww          , Ww          , Gs          , Re          , Hd          , Md          , Ww          , Ww          , Ww          , Ww          , Hd          , Hd          , Hd          , Ds          , Ds          , Ds          , Ds          , Hd          , Ww          , Ww          , Ww          , Ww          , Md          , Md          , Md          , Ww          , Ww          , Ww          , Ww          , Ww          , Dd          , Dd          , Gs^Ft       
Wo          , Wo          , Wo          , Wo          , Wo          , Wo          , Wo          , Ww          , Ww          , Ww          , Ww          , Gs          , Re          , Hd          , Md          , Ww          , Ww          , Ww          , Ww          , Ww          , Ww          , Hd          , Dd          , Dd          , Dd          , Ds          , Ds          , Ww          , Ww          , Ww          , Md          , Md          , Md          , Md          , Ww          , Ww          , Ww          , Ww          , Dd          , Dd          , Dd          , Gs^Ft       
Wo          , Wo          , Wo          , Wo          , Wo          , Wo          , Wo          , Ww          , Ww          , Ww          , Ww          , Ch          , 2 Kh        , Rd          , Md          , Md          , Md          , Ww          , Ww          , Md          , Ww          , Hd          , Hd          , Dd          , Dd          , Dd          , Dd          , Hd          , Md          , Md          , Md          , Md          , Md          , Md          , Md          , Md          , Md          , Hd          , Dd          , Dd          , Dd          , Dd          
Wo          , Wo          , Wo          , Wo          , Wo          , Wo          , Wo          , Ww          , Ww          , Ww          , Ww          , Gs^Ft       , Rd          , Rd          , Hd          , Md          , Md          , Md          , Md          , Md          , Md          , Hd          , Hd          , Hd          , Dd          , Dd          , Dd          , Dd          , Hd          , Md          , Md          , Md          , Md          , Hd          , Md          , Hd          , Hd          , Hd          , Dd          , Dd          , Dd          , Dd          
Wo          , Wo          , Wo          , Wo          , Wo          , Wo          , Wo          , Ww          , Ww          , Ww          , Ww          , Re          , Gs^Ft       , Dd          , Hd          , Md          , Md          , Md          , Md          , Md          , Md          , Md          , Hd          , Hd          , Dd          , Dd          , Dd          , Dd          , Dd          , Hd          , Hd          , Hd          , Gs          , Gs          , Hd          , Hd          , Dd          , Hd          , Dd          , Dd          , Dd          , Dd          
Wo          , Wo          , Wo          , Wo          , Wo          , Wo          , Wo          , Ww          , Ww          , Ww          , Ww          , Rd          , Re          , Gs^Ft       , Hd          , Md          , Md          , Md          , Md          , Md          , Md          , Md          , Md          , Hd          , Dd          , Dd          , Dd          , Dd          , Dd          , Gs          , Gs          , Gs          , Gs          , Gs^Ft       , Dd          , Dd          , Dd          , Dd          , Dd          , Dd          , Dd          , Dd          
Wo          , Wo          , Wo          , Wo          , Wo          , Wo          , Wo          , Ww          , Ww          , Ww          , Ww          , Dd          , Gs          , Re          , Hd          , Md          , Md          , Md          , Md          , Md          , Ww          , Ww          , Ww          , Ww          , Hd          , Dd          , Dd          , Dd          , Dd          , Gs^Ft       , Gs^Ft       , Gs          , Gs          , Dd          , Dd          , Dd          , Dd          , Dd          , Dd          , Dd          , Dd          , Hd          
Wo          , Wo          , Wo          , Wo          , Wo          , Wo          , Wo          , Wo          , Ww          , Ww          , Ww          , Ww          , Gs          , Re          , Rd          , Hd          , Md          , Md          , Md          , Ww          , Ww          , Ww          , Ww          , Ww          , Hd          , Dd          , Dd          , Dd          , Gs^Ft       , Gs^Ft       , Gs^Ft       , Gs^Ft       , Gs^Ft       , Dd          , Dd          , Dd          , Dd          , Dd          , Dd          , Dd          , Dd          , Dd          
