border_size=1
usage=map

Gs^Fds      , Gs^Fds      , Gs^Fds      , Gd^Fdf      , Gs^Fds      , Gs^Fds      , Gs^Fds      , Gg^Fet      , Gll^Efm     , Gd^Fdf      , Gs^Fds      , Gs^Fds      , Gs^Fds      , Gd^Fdf      , Gd^Fdf      , Gd^Fdf      , Gd^Fdf      , Gd^Fdf      , Gll^Fmf     , Gd^Fdf      , Gd^Fdf      , Gd^Fdf      , Gd^Fdf      , Gd^Fdf      , Rr          , Rb          , Rb          , Rb          , Gd^Efm      , Gd          , Gd^Es       , Rb          , Rb          , Rb          , Gd          , Gd          , Gd          , Rb          , Rb          , Rb          , Rr          , Hh          , Hhd^Fdw     , Hh          , Hh          , Hh          
Gs^Fds      , Gs^Fds      , Gs^Fds      , Gll^Ve      , Gs^Fds      , Gs^Fds      , Gg^Fet      , Gg^Fet      , Gll^Efm     , Gg^Fet      , Gs^Fds      , Gs^Fds      , Gs^Fds      , Gd^Fdf      , Gd^Fdf      , Gd^Fdf      , Gd^Fdf      , Gll^Fmf     , Gd^Fdf      , Gd^Fdf      , Gll^Fmf     , Gll^Fmf     , Gd^Fdf      , Gd^Fdf      , Gll         , Rr          , Rr          , Rb          , Rb          , Gd          , Gd^Es       , Gd          , Gd          , Gd^Efm      , Gd^Es       , Gd          , Gd^Es       , Rb          , Rr          , Rr          , Hh          , Hhd^Fdf     , Hhd^Fdw     , Hhd^Fdf     , Hh          , Hh          
Gs^Fds      , Gs^Fds      , Gs^Fds      , Gs^Fds      , Gs^Fds      , Gg^Fet      , Gll         , Gll^Efm     , Gg^Fet      , Gg^Fet      , Gs^Fds      , Gs^Fds      , Gs^Fds      , Gs^Fds      , Gs^Fds      , Gd^Fdf      , Gd^Fdf      , Gll^Fmf     , Gd^Fdf      , Gd^Fdf      , Gll^Fmf     , Gll^Fmf     , Gd^Fdf      , Gd^Fdf      , Gll^Fmf     , Gd^Fdf      , Gd^Fdf      , Rr          , Rr          , Gd^Efm      , Gd          , Gd          , Gd^Efm      , Gd          , Gd          , Gd          , Rb          , Rb          , Rr          , Rr          , Gs^Vh       , Hhd^Fdf     , Hhd^Fdf     , Hhd^Fdf     , Hh          , Hh          
Gs^Fds      , Gs^Fds      , Gs^Fds      , Gs^Fds      , Gll^Ve      , Gll^Efm     , Gg^Fet      , Gll^Efm     , Gll^Efm     , Gll^Ve      , Gs^Fds      , Gs^Fds      , Gs^Fds      , Gs^Fds      , Gs^Fds      , Gs^Fds      , Gd^Fdf      , Gd^Fdf      , Gd^Fdf      , Gd^Fdf      , Gd^Fdf      , Gd^Fdf      , Gll^Fdw     , Gs^Fdw      , Gs^Fdw      , Gll^Fmf     , Gll         , Gd^Fdf      , Gd^Fdf      , Rr          , Rb          , Rb^Es       , Gd          , Gd^Es       , Gd          , Rb          , Rr          , Rr          , Hhd^Fdf     , Hhd^Fdf     , Hhd^Fdf     , Hh          , Gs^Vh       , Hh          , Gd^Gvs      , Gd^Gvs      
Gs^Fds      , Gs^Fds      , Gs^Fds      , Gll^Efm     , Gll^Ve      , Gll^Efm     , Gll^Efm     , Gll^Efm     , Gll^Efm     , Gg^Ve       , Gs^Fds      , Gs^Fds      , Gs^Fds      , Gs^Fds      , Gs^Fds      , Gs^Fds      , Gd^Fdf      , Gd^Fdf      , Gd^Fdf      , Gd^Fdf      , Gll^Fmf     , Gd^Fdf      , Gll^Fdw     , Gll^Fdw     , Gll^Fdw     , Gd^Fdf      , Gd^Fdf      , Gd^Fdf      , Gll         , Rr          , Rr          , Rb          , Rb^Es       , Gd^Efm      , Rr          , Rr          , Hh^Efm      , Hh^Efm      , Hhd^Fdf     , Hhd^Fdw     , Hhd^Fdf     , Hh          , Hh^Vhh      , Rp^Vhcr     , Gd^Gvs      , Gd^Gvs      
Gs^Fds      , Gs^Fds      , Gs^Fds      , Gll^Ve      , Gll^Efm     , Gll^Efm     , Cv          , Gll^Efm     , Gll^Efm     , Gll^Efm     , Kv          , Cv          , Kv          , Gs^Fds      , Gs^Fds      , Gs^Fds      , Gd^Fdf      , Gd^Fdf      , Gll^Fmf     , Gd^Fdf      , Gd^Fdf      , Gll^Fmf     , Gll^Fmf     , Gs^Fdw      , Gd^Fdf      , Gd^Fdf      , Gd^Fdf      , Gd^Fdf      , Gd^Fdf      , Gd^Fdf      , Gd^Fdf      , Rr          , Gd          , Rb          , Rr          , Gd^Gvs      , Gd^Gvs      , Hh^Vhh      , Hh^Vhh      , Hhd^Fdf     , Hh          , Hh          , Gd^Gvs      , Gd^Gvs      , Gd^Gvs      , Gd^Gvs      
Gs^Fds      , Gs^Fds      , Cv          , Gd^Fdf      , Kv          , Cv          , 2 Kv        , Cv          , Cv^Efm      , Gll^Efm     , Gs^Fds      , Gs^Fds      , Gs^Fds      , Cv          , Gs^Fds      , Gd^Fdf      , Gd^Fdf      , Gll^Fmf     , Gd^Fdf      , Gd^Fdf      , Gll^Fmf     , Gll^Fmf     , Gd^Fdf      , Gd^Fdf      , Gd^Fdf      , Gd^Fdf      , Gd^Fdf      , Gd^Fdf      , Gd^Fdf      , Gd^Fdf      , Gd^Fdf      , Rr          , Rr          , Rr          , Gd^Gvs      , Gd^Gvs      , Gd^Gvs      , Gd^Gvs      , Gd^Gvs      , Hh          , Cea         , Cea         , Cea         , Gd^Gvs      , Aa^Gvs      , Aa^Gvs      
Gs^Fds      , Gs^Fds      , Gs^Fds      , Kv          , Gll^Ve      , Cv          , Cv          , Cv          , Gll^Efm     , Gll^Efm     , Gg^Fet      , Gg^Fet      , Gs^Fds      , Gs^Fds      , Gs^Fds      , Gd^Fdf      , Gd^Fdf      , Gd^Fdf      , Gd^Fdf      , Gd^Fdf      , Gd^Fdf      , Gd^Fdf      , Kv          , Gd^Fdf      , Gd^Fdf      , Gd^Fdf      , Wwf         , Wwf         , Wwf         , Ss          , Ss          , Gd^Fdf      , Rr          , Rr          , Hhd^Fdf     , Gd^Gvs      , Gd^Gvs      , Gd^Gvs      , Hh          , Hh          , Cea         , 3 Kea       , Cea         , Aa^Gvs      , Ha^Vhha     , Ha^Vhha     
Gs^Fds      , Gs^Fds      , Gll^Ve      , Gs^Fds      , Gg^Fet      , Gg^Fet      , Gll^Efm     , Gll^Efm     , Gg^Fet      , Gg^Fet      , Gs^Fds      , Gs^Fds      , Gs^Fds      , Gs^Fds      , Gd^Fdf      , Gd^Fdf      , Gd^Fdf      , Gd^Fdf      , Gll         , Gd^Fdf      , Gll         , Gd^Fdf      , Gd^Fdf      , Gd^Fdf      , Gd^Fdf      , Gd^Fdf      , Wwf         , Wwf         , Wwf         , Wwf         , Ss          , Gd^Fdf      , Gd^Fdf      , Rr          , Hh^Efm      , Hhd^Fdf     , Hhd^Fdf     , Hhd^Fdf     , Hh          , Hh          , Hhd         , Cea         , Ha^Fda      , Ha^Fda      , Ha^Fda      , Ha^Fda      
Gs^Fds      , Gs^Fds      , Gg^Fet      , Gg^Fet      , Gll^Efm     , Gll^Efm     , Gg^Fet      , Gg^Fet      , Gs^Fds      , Gs^Fds      , Gs^Fds      , Gs^Fds      , Gs^Fds      , Gs^Fds      , Gd^Fdf      , Gd^Fdf      , Gll         , Gll         , Gd^Fdf      , Gll         , Gd^Fdf      , Gd^Fdf      , Gd^Fdf      , Gd^Fdf      , Ss          , Ss          , Ss          , Wwf         , Wwf         , Wwf         , Ss          , Gd^Fdf      , Gd^Fdf      , Rr          , Hhd         , Hhd^Fdf     , Hhd^Fmf     , Hhd^Fdf     , Hhd^Fdw     , Hhd         , Hhd         , Ha^Fda      , Ha^Fda      , Ha^Fda      , Ha^Fda      , Ha^Fda      
Gs^Fds      , Gs^Fds      , Gll^Efm     , Gll^Efm     , Gg^Fet      , Gg^Fet      , Gs^Fds      , Gs^Fds      , Gs^Fds      , Gs^Fds      , Gs^Fds      , Gs^Fds      , Gd^Fdf      , Gd^Fdf      , Gd^Fdf      , Gll         , Gd^Fdf      , Gd^Fdf      , Gd^Fdf      , Gd^Fdf      , Gd^Fdf      , Gd^Fdf      , Gs^Fdw      , Gd^Fdf      , Ss          , Ss          , Ss          , Ss          , Sm          , Ss          , Gd^Fdf      , Gd^Fdf      , Gd^Fdf      , Rr          , Rr          , Hhd         , Hhd^Fdf     , Hhd^Fdw     , Hhd^Fdf     , Hhd^Fdw     , Ha^Fda      , Ha^Fda      , Ms          , Ms          , Ms          , Ha^Fda      
Gs^Fds      , Gs^Fds      , Gs^Fds      , Gll^Efm     , Gll^Efm     , Gs^Fds      , Gs^Fds      , Gs^Fds      , Gd^Fdf      , Gs^Fds      , Gd^Fdf      , Gd^Fdf      , Gd^Fdf      , Gd^Fdf      , Gll         , Gll         , Gd^Fdf      , Gd^Fdf      , Gd^Fdf      , Gll^Fmf     , Gll^Fmf     , Gll^Fdw     , Gll^Fdw     , Gll^Fdw     , Gd^Fdf      , Ss          , Ss          , Ss          , Sm          , Ss          , Gd^Fdf      , Gd^Fdf      , Gd^Fdf      , Gd^Fdf      , Rr          , Hhd         , Hhd         , Hhd^Fdf     , Hhd^Fmf     , Hhd^Fdw     , Ha^Fda      , Ms          , Ms          , Ms          , Ms          , Ms          
Gd^Fdf      , Gs^Fds      , Gd^Fdf      , Gd^Fdf      , Gd^Fdf      , Gll^Efm     , Gll         , Gs^Fds      , Gd^Fdf      , Gd^Fdf      , Gd^Fdf      , Gd^Fdf      , Gll         , Gll         , Gd^Fdf      , Gd^Fdf      , Gll^Fmf     , Gll^Fmf     , Gd^Fdf      , Gd^Fdf      , Gll^Fmf     , Gll^Fdw     , Gll^Fdw     , Gll^Fdw     , Gd^Fdf      , Ss          , Ss          , Ss          , Wwf         , Ss          , Gd^Fdf      , Gd^Fdf      , Gd^Fdf      , Gd^Fdf      , Rr          , Hhd         , Hhd^Fdf     , Hhd^Fdf     , Hhd^Fdf     , Hhd^Fdw     , Ha^Fda      , Ms          , Ms          , Ms          , Ms          , Ms          
Gd^Fdf      , Gd^Fmw      , Gd^Fmw      , Gd^Fdf      , Gd^Fdf      , Gd^Fdf      , Gd^Fdf      , Gll         , Gll         , Gd^Fdf      , Gll         , Gll         , Gll         , Gd^Fdf      , Gd^Fdf      , Gd^Fdf      , Gll^Fmf     , Gd^Fdf      , Gll^Fmf     , Gll^Fmf     , Gd^Fdf      , Gd^Fmw      , Gll^Fdw     , Gll^Fdw     , Gs^Fdw      , Sm          , Wwf         , Gd^Fdf      , Wwf         , Wwf         , Gd^Fdf      , Gd^Fdf      , Rr          , Rr          , Hhd^Fdf     , Hhd^Fdf     , Hhd^Fmf     , Hhd^Fdf     , Hhd^Fdf     , Hhd         , Hhd         , Ha^Fda      , Ms          , Ms          , Ms          , Ms          
Gd^Fdf      , Gd^Fdf      , Gs^Fdw      , Gd^Fmw      , Gd^Fdf      , Gd^Fdf      , Gd^Fdf      , Gd^Fdf      , Cv          , Gll         , Gd^Fdf      , Gd^Fdf      , Gd^Fdf      , Gll         , Gll         , Gd^Fdf      , Gd^Fdf      , Gd^Fdf      , Gd^Fdf      , Gd^Fdf      , Gd^Fdf      , Gd^Fmw      , Gs^Fdw      , Gll^Fdw     , Gll^Fdw     , Wwf         , Wwf         , Wwf         , Gd^Fdf      , Gd^Fdf      , Gd^Fdf      , Gd^Fdf      , Rr          , Hh          , Hhd^Fdf     , Hhd^Fdf     , Hhd^Fdf     , Hhd^Fdf     , Hhd         , Hhd         , Hh          , Ha^Fda      , Ha          , Ms          , Ms          , Ms          
Gd^Fdf      , Gll^Fdw     , Gll^Fdw     , Gll^Fdw     , Gd^Fdf      , Gll^Fmf     , Gd^Fdf      , Gd^Fdf      , Gd^Fdf      , Cv          , Cv          , Kv          , Cv          , Gd^Fdf      , Gd^Fdf      , Gll         , Gd^Fdf      , Gd^Fdf      , Gd^Fdf      , Gd^Fdf      , Gd^Fdf      , Gd^Fmw      , Gd^Fmw      , Gll^Fdw     , Gd^Fdf      , Wwf         , Wwf         , Wwf         , Wwf         , Gd^Fdf      , Gd^Fdf      , Gd^Fdf      , Rr          , Hh          , Hhd^Fdf     , Hhd^Fmf     , Hh          , Hh          , Hhd^Fmf     , Hhd^Fmf     , Hhd^Fdw     , Hhd         , Ha          , Ha^Fda      , Ha^Fda      , Ms          
Gd^Fdf      , Gll^Fdw     , Gs^Fdw      , Gd^Fmw      , Gd^Fdf      , Gd^Fdf      , Gll^Fmf     , Gll^Fmf     , Gd^Fdf      , Gd^Fdf      , Gd^Fmw      , Gd^Fmw      , Gd^Fmw      , Gd^Fdf      , Gd^Fdf      , Gll         , Gd^Fdf      , Gd^Fdf      , Gd^Fmw      , Gd^Fmw      , Gs^Fdw      , Gd^Fmw      , Gd^Fmw      , Gd^Fdf      , Gd^Fdf      , Ss          , Ss          , Ss          , Ss          , Ss          , Gd^Fdf      , Gd^Fdf      , Rr          , Hhd^Fdf     , Hhd^Fdf     , Hhd^Fmf     , Hhd         , Hh          , Hhd^Fmf     , Hhd^Fmf     , Hhd^Fdw     , Hh          , Ha          , Ha          , Ms          , Ha          
Gd^Fdf      , Gd^Fdf      , Gd^Fdf      , Gd^Fmw      , Gd^Fdf      , Gd^Fdf      , Gd^Fdf      , Gd^Fdf      , Gll^Fdw     , Gs^Fdw      , Gll^Fdw     , Gd^Fmw      , Gd^Fmw      , Gd^Fdf      , Gll         , Gll         , Gd^Fdf      , Gd^Fdf      , Gd^Fmw      , Gll^Fdw     , Gll^Fdw     , Gll^Fdw     , Gd^Fdf      , Gd^Fdf      , Gd^Fdf      , Ss          , Ss          , Ss          , Wwf         , Ss          , Gll^Fdw     , Gd^Fdf      , Rr          , Hhd^Fdf     , Hhd^Fdf     , Hhd^Fdf     , Hhd         , Hhd         , Hhd         , Hhd^Fmf     , Hhd         , Hhd         , Ms          , Ms          , Ms          , Ms          
Gd^Fdf      , Gd^Fdf      , Gd^Fdf      , Gd^Fdf      , Gd^Fmw      , Gd^Fdf      , Gd^Fdf      , Gd^Fdf      , Gll^Fdw     , Gll^Fdw     , Gll^Fdw     , Gd^Fmw      , Gll^Fmf     , Gd^Fdf      , Gll         , Gd^Fdf      , Gd^Fdf      , Gd^Fdf      , Gd^Fmw      , Gll^Fdw     , Gll^Fdw     , Gs^Fdw      , Gd^Fdf      , Gd^Fdf      , Gd          , Gd          , Ss          , Wwf         , Wwf         , Wwf         , Gll^Fdw     , Gll^Fdw     , Gd          , Rr          , Hh          , Hhd         , Hhd         , Hhd         , Hhd^Fmf     , Hhd         , Hhd         , Hhd         , Ms          , Ms          , Ms          , Ms          
Gd^Fdf      , Gd^Fdf      , Gd^Fdf      , Gd^Fmw      , Gll^Fdw     , Gd^Fmw      , Gd^Fdf      , Gd^Fdf      , Gd^Fdf      , Gs^Fdw      , Gd^Fdf      , Gd^Fdf      , Gll^Fmf     , Gd^Fdf      , Gd^Fdf      , Gll         , Gd^Fdf      , Gd^Fmw      , Gd^Fmw      , Gd^Fmw      , Gd^Fmw      , Gd^Fdf      , Gd^Fdf      , Gd^Fdf      , Gd          , Ss          , Ss          , Wwf         , Wwf         , Wwf         , Gll^Fdw     , Gll^Fdw     , Gd          , Rr          , Rr          , Hh          , Hh          , Hhd^Fmf     , Hhd^Fmf     , Hhd^Fdw     , Hhd         , Hh          , Ms          , Ms          , Ms          , Ms          
Gd^Fdf      , Gd^Fdf      , Gd^Fdf      , Gs^Fdw      , Gs^Fdw      , Gll^Fdw     , Gd^Fmw      , Gd^Fdf      , Gd^Fdf      , Gd^Fdf      , Gd^Fdf      , Gd^Fdf      , Gd^Fdf      , Gd^Fdf      , Gll         , Gd^Fdf      , Gd^Fdf      , Gd^Fdf      , Gd^Fdf      , Gd^Fdf      , Gd^Fmw      , Gd^Fmw      , Ss          , Ss          , Ss          , Ss          , Ss          , Wwf         , Wwf         , Wwf         , Gll^Fdw     , Gll^Fdw     , Gd          , Gd          , Rr          , Hh          , Hhd^Fdf     , Hhd^Fmf     , Hhd^Fmf     , Hhd^Fdw     , Hhd         , Hhd         , Ha          , Ms          , Ms          , Ms          
Gd^Fdf      , Gd^Fdf      , Gd^Fmw      , Gll^Fdw     , Gs^Fdw      , Gll^Fdw     , Gd^Fmw      , Gd^Fdf      , Gd^Fdf      , Gll^Fmf     , Gd^Fdf      , Gd^Fdf      , Gd^Fdf      , Gll         , Gll         , Gll         , Gll         , Gd^Fdf      , Gd^Fdf      , Kv          , Gd^Fmw      , Gd^Fmw      , Wwg         , Ss          , Wwg         , Wwg         , Wwg         , Wwg         , Wwg         , Wwg         , Gd          , Gd^Efm      , Gd^Fdf      , Gd^Fdf      , Rr          , Hhd^Fdf     , Hhd^Fdf     , Hhd^Fdf     , Hhd^Fmf     , Hh          , Hh          , Hhd         , Hhd         , Ha          , Ha          , Ha          
Gd^Fdf      , Gd^Fdf      , Gd^Fdf      , Gd^Fmw      , Gd^Fdf      , Gd^Fdf      , Gd^Fdf      , Gd^Fdf      , Gll^Fmf     , Gd^Fdf      , Gll^Fmf     , Gd^Fdf      , Gd^Fdf      , Gll         , Gd^Fdf      , Gll         , Gll         , Gd^Fdf      , Gd^Fdf      , Gd^Fdf      , Gd^Fmw      , Wwg         , Wwg         , Wwg         , Wwg         , Wwg         , Gd^Fdf      , Gd^Fdf      , Ss          , Gd^Fdf      , Sm          , Gd          , Gd^Fdf      , Gd^Fdf      , Rr          , Hhd^Fdf     , Hhd^Fdf     , Hhd^Fdf     , Hhd^Fmf     , Hhd         , Hhd         , Hhd^Fdw     , Hhd^Fdw     , Ha^Fda      , Ha^Fda      , Ha^Fda      
Gd^Fdf      , Gd^Fdf      , Gd^Fdf      , Gd^Fdf      , Gll^Fmf     , Gd^Fdf      , Gd^Fdf      , Gd^Fdf      , Gll^Fmf     , Gll^Fmf     , Gd^Fdf      , Gd^Fdf      , Gll^Fmf     , Gd^Fdf      , Gll         , Gll         , Gd^Fdf      , Gd^Fdf      , Gd^Fdf      , Gd^Fdf      , Ss          , Wwg         , Wwg         , Wwg         , Wwg         , Wwg         , Gd^Fdf      , Gd^Fdf      , Sm          , Sm          , Sm          , Sm          , Gd^Fdf      , Rr          , Hh          , Hh          , Hhd^Fmf     , Hhd^Fmf     , Hhd         , Hhd         , Hh^Efm      , Hhd^Fmf     , Hhd         , Hhd^Fdw     , Ha^Fda      , Ha^Fda      
Gd^Fdf      , Gd^Fdf      , Gd^Fdf      , Gll^Fmf     , Sm          , Sm          , Sm          , Ss          , Ss          , Gd^Fdf      , Gd^Fdf      , Gll^Fmf     , Gd^Fdf      , Gd^Fdf      , Gll^Fmf     , Gll^Fmf     , Gd^Fdf      , Gd^Fdf      , Gll         , Gll^Efm     , Gd          , Ss          , Ss          , Wwg         , Gd^Fdf      , Ss          , Gd^Fdf      , Gd^Fdf      , Gd^Fdf      , Sm          , Sm          , Sm          , Gd^Fdf      , Rr          , Hh          , Hh          , Hhd         , Hhd^Fmf     , Hhd         , Hh^Efm      , Hh^Efm      , Hhd         , Hhd         , Ha          , Ha          , Ha^Fda      
Gll^Fmf     , Gll^Fmf     , Gd^Fdf      , Gd^Fdf      , Sm          , Sm          , Sm          , Ss          , Ss          , Ss          , Sm          , Gd^Fdf      , Gd^Fdf      , Gd^Fdf      , Gll^Fmf     , Gll^Fmf     , Gd^Fdf      , Gd^Fdf      , Gd^Fdf      , Sm          , Sm          , Gd          , Sm          , Ss          , Sm          , Gd^Fdf      , Gd^Fdf      , Gd^Fdf      , Ss          , Ss          , Ss          , Gd^Fdf      , Gll^Fmw     , Rr          , Hhd^Fdf     , Hhd^Fdw     , Hhd^Fdw     , Hhd         , Hhd^Fdw     , Hhd         , Hhd         , Hhd         , Ha          , Ha^Fda      , Ha          , Ha          
Gll^Fmf     , Gll^Fmf     , Ss          , Gd^Fmw      , Gd^Fmw      , Sm          , Ss          , Ss          , Ss          , Ss          , Ss          , Ss          , Ss          , Gd^Fdf      , Gd^Fdf      , Gd^Fdf      , Gd^Fdf      , Gd^Fdf      , Gd^Fdf      , Ss          , Ss          , Sm          , Gd          , Sm          , Gd          , Sm          , Ss          , Ss          , Ss          , Ss          , Sm          , Gd^Fdf      , Gll^Fmw     , Rr          , Hhd^Fdf     , Hhd^Fdf     , Hhd^Fdw     , Hhd         , Hhd         , Hhd         , Ha          , Ha          , Ms          , Ms          , Ms          , Ha          
Ss          , Ss          , Ss          , Ss          , Gd^Fmw      , Rd          , Rd          , Ss          , Ss          , Sm          , Sm          , Sm          , Ss          , Gd^Fdf      , Ss          , Sm          , Sm          , Ss          , Sm          , Sm          , Sm          , Gd^Fdf      , Gd^Fdf      , Gd^Efm      , Sm          , Sm          , Gd          , Sm          , Sm          , Sm          , Ss          , Gd^Fdf      , Gd^Fdf      , Rr          , Hhd^Fdf     , Hhd^Fdf     , Hhd         , Hhd         , Ha          , Ha          , Ms          , Ms          , Ms          , Ms          , Ms          , Ms          
Ss          , Ss          , Gd^Fmw      , Gd^Fmw      , Wwf         , Wwf         , Wwf         , Rd          , Rd          , Gd^Fdf      , Rd          , Rd          , Rd          , Gd^Fdf      , Ss          , Sm          , Sm          , Ss          , Sm          , Sm          , Sm          , Gd^Fdf      , Ss          , Ss          , Ss          , Ss^Efm      , Gd          , Sm          , Gd          , Ss          , Ss          , Ss          , Gd          , Rr          , Hhd^Fdf     , Hhd         , Hhd         , Hhd         , Ha          , Ms          , Ms          , Ms          , Ms          , Ms          , Ms          , Ms          
Gd^Fmw      , Gd^Fmw      , Gd^Fmw      , Gd^Fmw      , Wwf         , Wwf         , Wwf         , Rd          , Wwf         , Rd          , Sm          , Sm          , Sm          , Ss          , Ss          , Ss          , Ss          , Ss          , Wwg         , Sm          , Ss          , Ss          , Sm          , Sm          , Sm          , Ss          , Ss          , Gd          , Ss          , Ss          , Ss          , Ss          , Gd          , Rr          , Hhd         , Hhd         , Ha          , Ha          , Ha          , Ms          , Ms          , Ms          , Ms^Xm       , Ms          , Ms          , Ms          
Gd^Fmw      , Gd^Fmw      , Wwf         , Ss          , Ss          , Ss          , Ss          , Wwf         , Wwf         , Wwf         , Sm          , Sm          , Sm          , Ss          , Gd^Fdf      , Ss          , Wwg         , Wwg         , Wwg         , Wwg         , Ss          , Ss          , Sm          , Sm          , Sm          , Ss          , Ss          , Ss          , Gll         , Gll         , Gd^Fdf      , Gd^Fdf      , Rr          , Rr          , Hh          , Hhd^Fmf     , Hhd^Fdw     , Ha^Fda      , Ha          , Ms          , Ms          , Ms          , Ms^Xm       , Mm^Xm       , Mm^Xm       , Ms          
Gd^Fmw      , Wwf         , Wwf         , Wwf         , Ss          , Gd^Fdf      , Ss          , Wwf         , Wwf         , Wwf         , Gd^Fdf      , Sm          , Gd^Fdf      , Gd^Fdf      , Gs^Fdw      , Gd^Fdf      , Wwg         , Wwg         , Wwg         , Wwg         , Wwg         , Sm          , Ss          , Sm          , Ss          , Ss          , Gll         , Gll         , Ss          , Sm          , Hhd^Fdw     , Gll^Fdw     , Rr          , Hh          , Hhd^Fdf     , Hhd^Fdw     , Ha          , Hhd^Fdw     , Ha^Fda      , Ms          , Ms          , Ms          , Ms          , Mm^Xm       , Mm^Xm       , Mm^Xm       
Gd^Fdf      , Wwf         , Wwf         , Wwf         , Rd^Cov      , Rd^Cov      , Rd^Cov      , Wwf         , Wwf         , Wwf         , Gd^Fdf      , Gd^Fdf      , Gll^Fdw     , Gll^Fdw     , Gll^Fdw     , Gd^Fdf      , Gd^Fdf      , Wwg         , Wwg         , Wwg         , Wwg         , Ss          , Ss          , Ss          , Sm          , Gll         , Sm          , Ss          , Sm          , Sm          , Gd^Fdf      , Gd^Fdf      , 1 Rr        , Hhd^Fdf     , Hhd^Fdf     , Hhd^Fdw     , Ha          , Ha          , Ha          , Ms          , Ms          , Ms          , Ms          , Mm^Xm       , Mm^Xm       , Mm^Xm       
Gd^Fdf      , Gd^Fdf      , Gd^Fdf      , Gd^Fdf      , Rd^Cov      , 4 Rp^Kov    , Rd^Cov      , Wwf         , Wwf         , Wwf         , Gd^Fdf      , Gd^Fdf      , Gs^Fdw      , Gll^Fmf     , Gll^Fmf     , Gd^Fdf      , Gd^Fdf      , Wwg         , Wwg         , Wwg         , Gd^Fdf      , Ss          , Ss          , Ss          , Gd^Fdf      , Sm          , Gll         , Ss          , Gll         , Gll         , Gd          , Gd^Fdf      , Rr          , Hhd^Fdf     , Hhd^Fdw     , Hhd^Fdw     , Ha^Fda      , Ha^Fda      , Ha          , Ms          , Ms          , Ms          , Ms          , Mm^Xm       , Mm^Xm       , Mm^Xm       
Gd^Fdf      , Gd^Fdf      , Gd^Fdf      , Gd^Fdf      , Gd^Fdf      , Rd^Cov      , Gd^Fdf      , Gd^Fdf      , Gd^Fdf      , Gd^Fdf      , Gd^Fdf      , Gd^Fdf      , Gd^Fdf      , Gll^Fdw     , Gd^Fdf      , Gll^Fmf     , Gd^Fdf      , Gd^Fdf      , Gd^Fdf      , Gd^Fdf      , Gd^Fdf      , Gd^Fdf      , Gd^Fdf      , Gd^Fdf      , Gd^Fdf      , Gd^Fdf      , Gd^Fdf      , Gll         , Gd^Fdf      , Gd^Fdf      , Gd^Fdf      , Rr          , Hh          , Hh          , Hh          , Hh          , Ha          , Ha^Fda      , Ha          , Ms          , Ms          , Ms          , Mm^Xm       , Mm^Xm       , Mm^Xm       , Mm^Xm       
