border_size=1
usage=map

Xuc         , Xuc         , Xuc         , Xuc         , Xuc         , Xuc         , Xuc         , Xuc         , Xuc         , Xuc         , Xuc         , Iwr         , Iwr         , Iwr         , Xol         , Xol         , Xol         , Gg          , Gg^Efm      , Gg          , Gg^Efm      , Gg          , Gg          , Gg          , Gg          , Gg          , Gg          , Gg          , Gg          , Gg          , Gg          , Gg          
Xuc         , Xuc         , Xuc         , Xuc         , Xuc         , Xuc         , Xuc         , Xuc         , Xuc         , Xuc         , Xuc         , Iwr         , 1 Iwr       , Iwr         , Xol         , Xol         , Xol         , Gg^Efm      , Gg^Efm      , Gg^Efm      , Gg^Efm      , Gg          , Gg          , Gg          , Gg          , Gg          , Gg          , Gg          , Gg          , Gg          , Gg          , Gg          
Xuc         , Xuc         , Xuc         , Xuc         , Urb         , Urb         , Urb         , Xuc         , Xuc         , Xuc         , Xuc         , Iwr         , Iwr         , Iwr         , Xol         , Xol         , Rrc         , Rrc         , Gg          , Gg          , Gg          , Gg          , Gg          , Gg          , Gg          , Gg          , Gg          , Gg          , Gg          , Gg          , Gg          , Gg          
Xuc         , Xuc         , Xuc         , Urb         , Urb         , Urb^Ii      , Urb         , Urb         , Xuc         , Xuc         , Xuc         , Iwr         , Iwr         , Iwr         , Iwr         , Rrc         , Rrc         , Rrc         , Gg          , Gg          , Gg          , Gg          , Gg          , Gg          , Gg          , Gg          , Gg          , Gg          , Gg          , Gg          , Gg          , Gg          
Xuc         , Xuc         , Xuc         , Urb         , Urb         , 2 Urb       , Urb         , Urb         , Urb         , Xuc         , Xuc         , Iwr         , Iwr         , Iwr         , Iwr         , Iwr         , Xol         , Rrc         , Gg          , Gg          , Gg          , Gg          , Gg          , Gg          , Gg          , Gg          , Gg          , Gg          , Gg^Efm      , Gg          , Gg^Efm      , Gg          
Xuc         , Xuc         , Xuc         , Xuc         , Xuc         , Urb         , Xuc         , Xuc         , Xuc         , Urb         , Urb         , Iwr         , Iwr         , Iwr         , Xol         , Xol         , Xol         , Gg          , Gg          , Gg          , Gg          , Gg          , Gg          , Gg          , Gg          , Gg          , Gg          , Gg^Efm      , Gg          , Gg^Efm      , Gg^Efm      , Gg          
Xuc         , Xuc         , Xuc         , Xuc         , Xuc         , Xuc         , Xuc         , Xuc         , Xuc         , Xuc         , Xuc         , Iwr         , Iwr         , Iwr         , Xol         , Xol         , Xol         , Xos         , Xos         , Xos         , Xos         , Xos         , Xos         , Xos         , Xos         , Gg          , Gg          , Gg^Efm      , Gg          , Gg^Efm      , Gg^Efm      , Gg          
Xuc         , Xuc         , Xuc         , Xuc         , Xuc         , Xuc         , Xuc         , Xuc         , Xuc         , Xuc         , Xuc         , Iwr         , Iwr         , Iwr         , Xol         , Xol         , Xol         , Xos         , Xos         , Xos         , Xos         , Xos         , Xos         , Xos         , Xos         , Xos         , Gg          , Gg          , Gg          , Gg          , Gg          , Gg          
