border_size=1
usage=map

Ds          , Wo          , Ww          , Ww          , Gs^Fp       , Ww          , Ww          , Gg          , Gs^Fp       , Gs^Fp       , Gs^Fp       , Ww          , Ww          , Ww          , Hh          , Gg          , Gg          , Gg          , Gg          , Gg          , Gg          , Gg          , Gg          , Rr          , Gs          , Gg          , Gg          , Gg          , Gg          , Gs^Fp       , Gs^Fp       , Gg          
Ds          , Wo          , Ww          , Ds          , Rr          , Ww^Bw/      , Ww          , Gg^Vh       , Gs^Fp       , Gg          , Ww          , Ww          , Ww          , Ww          , Ww          , Hh          , Gg          , Gg          , Gg          , Ds          , Gg          , Gg          , Rr          , Rr          , Gg          , Gs          , Gg          , Gg          , Gg          , Gg          , Gs^Fp       , Gg          
Gs^Fp       , Ds          , Ds          , Gg^Vh       , Rr          , Ww          , Ww          , Ww          , Gs^Fp       , Ww          , Ww          , Ww          , Ww          , Ww          , Ww          , Ww          , Ww          , Gg          , Gg          , Gg          , Gg          , Rr          , Gg          , Gg          , Gg          , Gg          , Gg          , Gg          , Gg          , Gg          , Gg          , Gg          
Gg          , Gs^Fp       , Ss          , Gg          , Rr          , Ww          , Ww          , Ww          , Gs^Fp       , Gg          , Ww          , Ww          , Ww          , Ww          , Ww          , Ww          , Ww          , Gg          , Gg          , Gg          , Rr          , Rr          , Gs          , Gs          , Gg          , Gg^Vh       , Gg          , Gg          , Gg          , Gg          , Gg          , Gg          
Gg          , Gg          , Rr          , Rr          , Gg          , Ww          , Ww          , Ww          , Gs^Fp       , Gg          , Ww          , Ww          , Ww          , Ww          , Gs^Vh       , Gg^Cov      , Rr^Cov      , Gg          , Rr          , Rr          , Gg          , Gg          , Gg          , Gg          , Gg          , Gs          , Rr          , Gg          , Rr          , Rr          , Rr          , Rr          
Gg          , Rr          , Gs^Fp       , Ss          , Gg          , Ww          , Gg          , Gg          , Gg          , Ww          , Ww          , Ww          , Ww          , Gg          , Gg^Cov      , Gg^Kov      , Gg^Cov      , Gg^Vh       , Rr          , Gs^Fp       , Gs^Fp       , Gs^Fp       , Gg          , Gg          , Rr          , Rr          , Gs          , Rr          , Gs          , Gg          , Gg          , Gg          
Rr          , Rr          , Gg          , Gs^Fp       , Gs^Fp       , Ww          , Gs^Fp       , Gs^Fp       , Gg          , Ww          , Ww          , Ww          , Gg          , Rr^Vhc      , Gg          , Rr^Vhc      , Gg          , Gg          , Rr          , Gg          , Gg          , Gd          , Rr          , Rr          , Gs          , Gs          , Gs          , Gs          , Gs          , Gs          , Gs          , Gs          
Rr          , Gg          , Gg          , Gg          , Gg          , Ww          , Ww          , Ww          , Ww          , Ww          , Gg          , Ww          , Gg          , Gg          , Rr^Vhc      , Rr^Vhc      , Gg          , Rr^Vhc      , Rr          , Gg          , Rr          , Rr          , Hh          , Gs          , Gs          , Gs          , Gs          , Gs          , Gs          , Gs          , Gs          , Gs          
Gg          , Gg          , Gg          , Gg          , Gg          , Ww          , Ww          , Gg          , Gg          , Gg          , Gg          , Gg          , Gg          , Gg          , Rr          , Rr          , Rr          , Rr          , Rr^Vhc      , Rr          , Gs^Fp       , Gs^Fp       , Hh          , Gs          , Gs          , Gs          , Gs          , Gs          , Gs          , Gs          , Gs          , Gs          
Gg          , Gg          , Gg          , Gs^Fp       , Gs^Fp       , Ww          , Ww          , Gg          , Gg          , Gg          , Gg          , Gg          , Gg          , Rr          , Rr          , Rr^Vhc      , Rr          , Rr          , Gs^Fp       , Rr^Vhc      , Gs^Fp       , Gs^Fp       , Hh          , Hh          , Hh          , Gs          , Gs          , Gs          , Gs          , Gs          , Gs          , Gs          
Gg          , Gg          , Gs^Fp       , Gs^Fp       , Gg          , Gg          , Ww          , Ww          , Gs^Fp       , Gs^Fp       , Gg          , Gg          , Gg          , Rr          , Rr^Vhc      , Gg          , Rr          , Gg          , Hh          , Hh          , Gs^Fp       , Mm          , Hh          , Hh          , Gg          , Hh          , Gs          , Gs          , Gs          , Gs          , Gs          , Gs          
Gg          , Gg          , Gs^Fp       , Ss          , Gg          , Gg          , Gg          , Ww          , Ww          , Gg          , Gs^Fp       , Gg          , Rr          , Rr          , Gg          , Gg          , Rr          , Hh          , Mm          , Mm          , Mm          , Mm          , Gs^Fp       , Gg          , Gg          , Gg^Vh       , Gs          , Gs          , Gs          , Gs          , Gs          , Gs          
Gg          , Gs^Fp       , Gs^Fp       , Ss          , Ss          , Gg          , Gg          , Ww          , Ww          , Gg          , Gs^Fp       , Gg          , Rr          , Gg          , Gg          , Rr          , Gs          , Gs          , Mm          , Mm          , Mm          , Mm          , Mm          , Gg          , Gg          , Gg          , Gg          , Gs          , Gs          , Gs          , Gs          , Gs          
Rr          , Ds          , Ds          , Ds          , Ss          , Ss          , Gg          , Gs^Fp       , Gs^Fp       , Ww          , Co          , Ww          , Rp          , Gg          , Rr          , Rr          , Gg          , Gs          , Mm          , Mm          , Mm          , Mm          , Gs^Fp       , Gs^Fp       , Gg          , Ss          , Ss          , Gs^Fp       , Gg          , Gg          , Gs          , Gs          
Ds          , Rr          , Rr          , Ds          , Gs^Fp       , Gs^Fp       , Gs^Fp       , Co          , Co          , Co          , Co          , Co          , Ko          , Gg          , Rr          , Gs          , Gs          , Gs          , Mm          , Mm          , Mm          , Mm          , Gg          , Gg          , Gs^Fp       , Gg          , Gs^Fp       , Gg          , Gg          , Gs          , Gs          , Gs          
Gs^Fp       , Gs^Fp       , Rr          , Ds          , Gg          , Gs          , Gs          , Gs          , Gg          , Gs^Fp       , Ww          , Co          , Rr          , Rr          , Gg          , Gs          , Gs          , Gs          , Gs          , Gs          , Gg^Vh       , Mm          , Gg          , Gg          , Gg          , Gg          , Gg          , Gg          , Gs          , Gg          , Gg          , Gs          
Gg          , Gs^Fp       , Gg          , Rr          , Rr          , Gs          , Rr          , Rr          , Rr          , Gg^Vh       , Rr          , Rr          , Gg          , Gg          , Gg          , Gs          , Gs          , Gg          , Gg          , Ww          , Ww          , Gg          , Gg          , Gs          , Gs          , Gs          , Gs          , Gs          , Gs          , Gg          , Gg          , Gg          
Gg          , Gg          , Ww          , Gg          , Ww          , Rr          , Rr          , Gg          , Gg          , Rr          , Gg          , Gg          , Gg          , Gg          , Gg          , Gg          , Gg          , Gg          , Gg          , Gg          , Ww          , Gs^Fp       , Gg          , Gg          , Gs          , Gs          , Gg          , Gg          , Gg          , Gg          , Gg          , Gs^Fp       
Gg          , Ww          , Ww          , Gg          , Ww          , Ww          , Gg          , Rr          , Rr          , Gg          , Gg          , Gg          , Gg          , Gg          , Gg          , Gg          , Gg          , Gg          , Gs^Fp       , Gs^Fp       , Gg^Vh       , Ww          , Ww          , Ww          , Gg^Vh       , Gg          , Gg          , Gg          , Gg          , Gg          , Gs^Fp       , Gs^Fp       
Ww          , Ww          , Ww          , Ww          , Ww          , Gg          , Gs^Fp       , Gs^Fp       , Gs^Fp       , Rr          , Rr          , Gg          , Gg          , Gg          , Gg          , Gg          , Gs^Fp       , Gs^Fp       , Gg          , Gg          , Gs^Fp       , Gs^Fp       , Gg          , Ww          , Gg          , Gg          , Gg          , Gg          , Gs^Fp       , Gs^Fp       , Gs^Fp       , Gg          
Ww          , Ww          , Ww          , Ww          , Ww          , Ww          , Gs^Fp       , Gs^Fp       , Gs^Fp       , Gs^Fp       , Rr          , Gg          , Gg          , Gg          , Gg          , Gs^Fp       , Gs^Fp       , Gg          , Gg          , Gg          , Gs^Fp       , Gs^Fp       , Gg          , Ww          , Ww          , Gg          , Gg          , Gs^Fp       , Gs^Fp       , Gg          , Gg          , Gs^Fp       
Ww          , Ww          , Ww          , Ww          , Ww          , Ww          , Ww          , Gg          , Gs^Fp       , Gs^Fp       , Rr          , Gg          , Gg          , Gg          , Gg          , Gg          , Gs^Fp       , Gs^Fp       , Gs^Fp       , Gs^Fp       , Gs^Fp       , Gs^Fp       , Ww          , Ww          , Ww          , Gg          , Gg          , Gs^Fp       , Gs^Fp       , Gs^Fp       , Gs^Fp       , Gg          
