border_size=1
usage=map

Gg          , Gg          , Gd          , Gg          , Gd          , Gg          , Gg          , Gg          , Gg          , Gg          , Gg          , Rr          , Rr          , Gg          , Gg          , Gg          , Gg          , Ha^Fda      , Ha^Fda      , Ha^Fda      , Ha^Fda      , Ha^Fma      , Ha^Fpa      , Ha^Fma      , Ha^Fpa      , Ha^Fma      , Ha^Fpa      , Ha^Fma      , Ha^Fpa      , Ha^Fma      , Ms          , Gg          
Gg          , Gd          , Gs^Cov      , Gs^Cov      , Gs^Cov      , Gd          , Gd          , Gg          , Gg^Efm      , Gg^Efm      , Gg^Efm      , Gg^Efm      , Gg          , Rr          , Rr          , Gg          , Gg          , Ha^Fda      , Ha^Fda      , Ha^Fda      , Ha^Fda      , Ha^Fpa      , Ha^Fpa      , Ha^Fma      , Ha^Fpa      , Ha^Fpa      , Ha^Fpa      , Ha^Fma      , Ms          , Ms          , Ms          , Ms          
Gg          , Gd          , 2 Gg^Kov    , Gs^Cov      , Gs^Cov      , Gs^Cov      , Gd          , Gg          , Hh^Fms      , Mm          , Mm          , Mm          , Mm          , Gg          , Rr          , Gg          , Gg          , Ha^Fda      , Ha^Fda      , Ha^Fda      , Ha^Fma      , Ha^Fpa      , Ha^Fma      , Ha^Fpa      , Ha^Fma      , Ha^Fpa      , Ms          , Ms          , Ms          , Ms          , Ms          , Ms          
Gg          , Gd          , Gs^Cov      , Gs^Cov      , Gd          , Gd          , Gg          , Gg          , Mm          , Mm          , Mm          , Mm          , Mm          , Gg          , Gg          , Rr          , Rr          , Gg          , Gg          , Ha^Fma      , Ha^Fma      , Ha^Fpa      , Ha^Fma      , Ha^Fpa      , Ha^Fma      , Ms          , Ms          , Ms          , Ms          , Ms          , Ha          , Ha          
Gg          , Gd          , Gd          , Gd          , Gd          , Gd          , Mm          , Mm          , Mm          , Mm          , Hh^Fds      , Hh^Fms      , Hh          , Gg          , Gg          , Gg          , Rr          , Gg          , Gg          , Ha^Fma      , Ha^Fma      , Ha^Fma      , Ha^Fpa      , Ha^Fpa      , Ms          , Ms          , Ms          , Ms          , Ms          , Ms          , Ha          , Ha          
Mm          , Gg          , Mm          , Mm          , Mm          , Mm          , Mm          , Mm          , Hh^Fms      , Hh^Fp       , Hh          , Hh          , Gg          , Gg          , Gg          , Gg          , Gg          , Rr          , Rr          , Gg          , Ha^Fpa      , Ha^Fpa      , Ms          , Ms          , Ms          , Ms          , Ms          , Ms          , Ha          , Ha          , Ha          , Ha          
Mm          , Mm          , Mm          , Mm          , Hh^Fds      , Mm          , Mm          , Mm          , Mm          , Hh          , Hh          , Gg^Efm      , Gg          , Gg          , Gg          , Gg          , Gg          , Gg          , Rr          , Gg          , Gg          , Ms          , Ms          , Ms          , Ms          , Ms          , Ha          , Ha          , Ha          , Ha          , Ha          , Ha          
Gg          , Gg^Efm      , Wwt         , Gg^Efm      , Wwt         , Mm          , Hh          , Mm          , Hh          , Hh          , Gg          , Gg          , Gg          , Gg          , Gg          , Gg          , Gg          , Gg          , Rr          , Gg          , Gg          , Ms          , Ms          , Ms          , Wwt         , Ha          , Wwt         , Wwt         , Wwt         , Wwt         , Wwt         , Wwt         
Wwt         , Wwt         , Gg          , Wwt         , Wwt         , Hh          , Gg^Efm      , Hh          , Gg          , Gg          , Gg          , Gg          , Gg          , Gg          , Gg          , Gg          , Gg          , Gg          , Gg^Bsb|     , Gg          , Wwt         , Wwt         , Wwt         , Wwt         , Wwt         , Wwt         , Wwt         , Wwt         , Aa^Fma      , Aa^Fma      , Aa^Fma      , Aa^Fma      
Gg          , Gg          , Hh^Fp       , Gg          , Gg          , Wwt         , Wwt         , Gg          , Gg          , Gg          , Gg          , Gg          , Gg          , Gg          , Wwt         , Gg          , Wwt         , Wwt         , Wwt^Bsb|    , Wwt         , Wwt         , Wwt         , Gg^Efm      , Wwt         , Gg^Efm      , Wwt         , Gs^Gvs      , Gg^Gvs      , Gg^Gvs      , Gs^Fds      , Gs^Fms      , Gs^Fms      
Gg          , Hh^Fp       , Hh^Fp       , Hh^Fp       , Hh^Fp       , Gg          , Gg          , Wwt         , Wwt         , Wwt         , Wwt         , Wwt         , Wwt         , Wwt         , Wwt         , Wwt         , Gg^Es       , Wwt         , Rrc^Cov     , Gg^Cov      , Gg^Cov      , Gs^Vh       , Gg^Efm      , Gg^Efm      , Gs^Vh       , Gg^Gvs      , Gg^Gvs      , Gg^Gvs      , Gg^Gvs      , Gs^Vh       , Gs^Fms      , Aa^Fma      
Gg          , Hh^Fp       , Hh^Fp       , Hh^Fp       , Hh^Fp       , Hh^Fp       , Gs^Fms      , Gg          , Wwt         , Wwt         , Gg^Es       , Gg^Es       , Gg^Es       , Wwt         , Gg^Es       , Gg^Es       , Rr^Vhc      , Rr^Vhc      , Rrc^Cov     , 1 Rrc^Kov   , Rrc^Cov     , Rr^Vhc      , Rr^Vhc      , Gg^Efm      , Gg^Efm      , Gs^Vh       , Gg^Efm      , Gg^Gvs      , Gg          , Gg^Efm      , Aa^Fma      , Gs^Fms      
Gs^Fms      , Gs^Fms      , Hh^Fp       , Hh^Fp       , Hh^Fp       , Hh^Fp       , Hh^Fp       , Gg          , Wwt         , Wwt         , Gg^Es       , Gg^Efm      , Gg^Es       , Gg^Es       , Rr^Vhc      , Rr^Vhc      , Rrc         , Rrc         , Rr^Vhc      , Rr^Cov      , Rr^Vhc      , Rrc         , Rrc         , Rr^Vhc      , Rr^Vhc      , Gg^Efm      , Rr^Vhc      , Rr^Vhc      , Gs^Vh       , Gs^Fms      , Gs^Fds      , Gs^Fms      
Gg          , Gs^Fms      , Hh^Fp       , Hh^Fp       , Hh^Fp       , Hh^Fp       , Hh^Fp       , Gs^Fms      , Gg          , Wwt         , Wwt         , Gg^Es       , Gg^Es       , Hh^Vhh      , Rrc         , Rrc         , Rr^Vhc      , Rr^Vhc      , Gg^Gvs      , Gg^Gvs      , Gg^Gvs      , Rr^Vhc      , Rr^Vhc      , Rrc         , Rrc         , Rrc         , 4 Rrc       , Rr^Vhc      , Gg^Efm      , Gs^Fds      , Aa^Fma      , Aa^Fma      
Gg          , Gs^Fms      , Gs^Fms      , Hh^Fp       , Hh^Fp       , Hh^Fp       , Hh^Fp       , Hh^Fp       , Gs^Fms      , Wwt         , Wwt         , Wwt         , Wwt         , Rr^Vhc      , Rrc         , Rr^Vhc      , Gg^Efm      , Gs^Vh       , Gg^Gvs      , Gs^Vh       , Gg^Gvs      , Gs^Vh       , Rr^Vhc      , Rr^Vhc      , Rr^Vhc      , Rrc         , Rrc         , Rr^Vhc      , Uu^Vud      , Gs^Fms      , Gs^Fds      , Aa^Fma      
Gg          , Gg          , Gs^Fms      , Hh^Fp       , Hh^Fp       , Hh^Fp       , Hh^Fp       , Hh^Fp       , Hh^Fp       , Gs^Fms      , Hh          , Wwt         , Wwt         , Wwt         , Wwt^Bsb|    , Gg^Efm      , Gg          , Gg^Efm      , Gg^Gvs      , Gg^Gvs      , Rr^Vhc      , Rr^Vhc      , Rr^Vhc      , Rr^Vhc      , Gg^Gvs      , Gg^Gvs      , Gg^Gvs      , Rrc         , Rr          , Gs^Fds      , Gs^Fms      , Gs^Fms      
Gg          , Gg          , Gg          , Gs^Fms      , Hh^Fp       , Hh^Fp       , Hh^Fp       , Hh^Fp       , Hh^Fp       , Hh^Cov      , Hh^Cov      , Hh          , Gs          , Wwt         , Wwt^Bsb|    , Wwt         , Wwt         , Gg          , Gg          , Gg          , Gg^Efm      , Rr^Vhc      , Gg^Gvs      , Gg^Gvs      , Gg^Gvs      , Gg^Gvs      , Gg^Efm      , Gg^Efm      , Gg^Efm      , Rr          , Rr          , Rr          
Rp          , Gg          , Rp          , Gg          , Gg          , Hh^Fp       , Gs^Fms      , Hh^Fp       , Hh^Fp       , 3 Hh^Kov    , Hh^Cov      , Hh^Cov      , Gg          , Gg^Es       , Rp          , Wwt         , Wwt         , Wwt         , Wwt         , Gg          , Gg          , Gg^Efm      , Gg          , Gg^Gvs      , Gg          , Gg          , Gg          , Gg          , Wwt         , Gg          , Wwt         , Gg          
Gll^Fp      , Rp          , Gll^Fp      , Rp          , Rp          , Rp          , Rp          , Gg          , Rp          , Gg^Cov      , Rp          , Gg^Cov      , Rp          , Rp^Efm      , Aa^Fpa      , Aa^Fpa      , Gll^Fp      , Wwt         , Wwt         , Wwt         , Wwt         , Gg          , Wwt         , Gg          , Wwt         , Wwt         , Wwt         , Wwt         , Wwt         , Wwt         , Gll^Fp      , Wwt         
Gll^Fp      , Gll^Fp      , Gs^Fms      , Gll^Fp      , Gll^Fp      , Gs^Fms      , Gll^Fp      , Rp          , Gs^Fms      , Rp          , Gll^Fp      , Rp          , Gll^Fp      , Gg          , Gs^Fms      , Gs^Fms      , Gll^Fp      , Gll^Fp      , Gll^Fp      , Wwt         , Wwt         , Wwt         , Wwt         , Wwt         , Gll^Fp      , Gll^Fp      , Gll^Fp      , Gll^Fp      , Gll^Fp      , Gll^Fp      , Gs^Fms      , Gg          
Gll^Fp      , Gll^Fp      , Gll^Fp      , Gs^Fms      , Gll^Fp      , Gll^Fp      , Gll^Fp      , Gll^Fp      , Gs^Fms      , Gll^Fp      , Gs^Fms      , Gs^Fms      , Gs^Fms      , Aa^Fpa      , Aa^Fpa      , Gll^Fp      , Gs^Fms      , Gs^Fms      , Gs^Fms      , Gll^Fp      , Gg          , Wwt         , Gg          , Gg^Efm      , Gll^Fp      , Gs^Fms      , Aa^Fpa      , Aa^Fpa      , Gll^Fp      , Aa^Fpa      , Gs^Fms      , Gg          
Gg          , Gs^Fms      , Gs^Fms      , Gll^Fp      , Gs^Fms      , Gs^Fms      , Aa^Fpa      , Aa^Fpa      , Aa^Fpa      , Aa^Fpa      , Aa^Fpa      , Aa^Fpa      , Gll^Fp      , Aa^Fpa      , Gll^Fp      , Gll^Fp      , Gll^Fp      , Gll^Fp      , Gll^Fp      , Gll^Fp      , Gg          , Gg          , Gg          , Gg^Efm      , Gg          , Gs^Fms      , Aa^Fpa      , Aa^Fpa      , Gg          , Gs^Fms      , Gg          , Gg          
