border_size=1
usage=map

Ur          , Ur          , Ur          , Ur          , Ur          , Xos         , Urb         , Urb         , Urb         , Urb         , Urb         , Urb         , Urb         , Urb         , Xos         , Xos         , Xos         , Xu          , Xu          , Xu          , Xu          , Xu          , Xu          , Xu          , Xu          , Xu          , Xu          , Xu          , Xu          , Xu          , Xu          , Xu          
Ur          , Ur          , Ur          , Ur          , Ur          , Xos         , Urb         , Urb         , Urb         , Urb         , Urb         , Urb         , Xos         , Urb         , Xos         , Xos         , Xos         , Xu          , Xu          , Xu          , Xu          , Xu          , Xu          , Xu          , Xu          , Xu          , Xu          , Xu          , Xu          , Xu          , Xu          , Xu          
Ur          , Ur          , Ur          , Ur          , Xos         , Xos         , Urb         , Urb         , Urb         , Urb         , Xos         , Xos         , Iwr         , Xos         , Xos         , Xos         , Xu          , Xu          , Xu          , Xu          , Xu          , Xu          , Ur          , Xu          , Xu          , Xu          , Xu          , Xu          , Xu          , Xu          , Xu          , Xu          
Ur          , Ur          , Urb         , Xos         , Urb         , Urb         , Urb         , Urb         , Xos         , Urb         , Iwr         , Iwr         , Iwr         , Iwr         , Iwr         , Xos         , Xos         , Xu          , Xu          , Xu          , Ur          , Ur          , Uue         , Xu          , Ur          , Ur          , Ur          , Xu          , Xu          , Xu          , Xu          , Xu          
Xos         , Xos         , Urb         , Urb         , Urb         , Xos         , Xos         , Xos         , Iwr         , Iwr         , Iwr         , Iwr         , Iwr         , Iwr         , Iwr         , Iwr         , Xos         , Xos         , Xu          , Ur          , Uue         , Uue         , 2 Kud       , Uue         , Uue         , Xu          , Xu          , Ur          , Ur          , Xu          , Xu          , Xu          
Ur          , Xos         , Xos         , Urb         , Urb         , Urb         , Urb         , Xos         , Xos         , Iwr         , Iwr         , Iwr         , Iwr         , Iwr         , Xos         , Xos         , Xu          , Xu          , Ur          , Ur          , Uue         , Cud         , Cud         , Uue         , Uue         , Uue         , Xu          , Xu          , Ur          , Xu          , Xu          , Xu          
Ur          , Ur          , Ur          , Xos         , Urb         , Urb         , Urb         , Urb         , Urb         , Xos         , Xos         , Iwr         , Xos         , Xos         , Xu          , Xu          , Xu          , Xu          , Ur          , Uue         , Uue         , Uue         , Uue         , Cud         , Uue         , Xu          , Xu          , Xu          , Ur          , Xu          , Xu          , Xu          
Ur          , Ur          , Ur          , Ur          , Ur          , Xos         , Xos         , Urb         , Urb         , Urb         , Xu          , Xos         , Xu          , Xu          , Xu          , Xu          , Xu          , Xu          , Xu          , Ur          , Ur          , Uue         , Ur          , Uue         , Ur          , Ur          , Ur          , Ur          , Xu          , Xu          , Xu          , Xu          
Xu          , Ur          , Ur          , Ur          , Ur          , Ur          , Xu          , Xos         , Xu          , Xue         , Xue         , Xu          , Xu          , Xu          , Xu          , Xu          , Xu          , Xu          , Ur          , Ur          , Uue         , Uue         , Xu          , Ur          , Xu          , Ur          , Xu          , Xu          , Xu          , Xu          , Xu          , Xu          
Xu          , Xu          , Xu          , Xu          , Xu          , Xu          , Xu          , Xu          , Xu          , Xu          , Xu          , Ur          , Ur          , Xu          , Ur          , Xu          , Ur          , Ur          , Uue         , Uue         , Xu          , Xu          , Xu          , Xu          , Xu          , Xu          , Xu          , Xu          , Xu          , Xu          , Xu          , Xu          
Xu          , Xu          , Xu          , Xu          , Xu          , Xu          , Xu          , Xu          , Xu          , Xu          , Xu          , Xu          , Ur          , Ur          , Ur          , Ur          , Uue         , Uue         , Xu          , Xu          , Xu          , Xu          , Xu          , Xu          , Xu          , Xu          , Xu          , Xu          , Xu          , Xu          , Xu          , Xu          
Xu          , Xu          , Xu          , Xu          , Xu          , Xu          , Ur          , Ur          , Ur          , Ur          , Ur          , Xu          , Ur          , Uue         , Uue         , Uue         , Xu          , Xu          , Xu          , Xu          , Xu          , Xu          , Xu          , Xu          , Xu          , Xu          , Xu          , Xu          , Ur          , Xu          , Xu          , Xu          
Xu          , Xu          , Xu          , Xu          , Xu          , Xu          , Ur          , Ur          , Uue         , Uue         , Uue         , Ur          , Uue         , Uue         , Xu          , Xu          , Xu          , Xu          , Xu          , Xu          , Ur          , Xu          , Xu          , Xu          , Xu          , Xu          , Uue         , Ur          , Uue         , Ur          , Xu          , Xu          
Xu          , Xu          , Xu          , Xu          , Xu          , Xu          , Ur          , Uue         , Uue         , Uue         , Ur          , Uue         , Xu          , Xu          , Xu          , Xu          , Xu          , Xu          , Ur          , Ur          , Ur          , Ur          , Ur          , Xu          , Uue         , Uue         , Uue         , Uue         , Uue         , Ur          , Ur          , Xu          
Xu          , Xu          , Xu          , Xu          , Xu          , Xu          , Ur          , Ur          , Ur          , Uue         , Ur          , Uue         , Xu          , Xu          , Xu          , Xu          , Ur          , Ur          , Uue         , Uue         , Uue         , Uue         , Uue         , Uue         , Ur          , Uue         , Uue         , Uue         , Uue         , Uue         , Ur          , Xu          
Xu          , Xu          , Xu          , Xu          , Xu          , Xu          , Xu          , Ur          , Xu          , Ur          , Ur          , Uue         , Uue         , Xu          , Ur          , Ur          , Uue         , Ur          , Uue         , Uue         , Uue         , Uue         , Uue         , Ur          , Xu          , Ur          , Uue         , Uue         , Ur          , Ur          , Xu          , Xu          
Xu          , Xu          , Xu          , Xu          , Xu          , Xu          , Xu          , Xu          , Xu          , Xu          , Xu          , Ur          , Ur          , Uue         , Uue         , Uue         , Ur          , Uue         , Uue         , Uue         , Ur          , Uue         , Xu          , Xu          , Xu          , Ur          , Ur          , Ur          , Xu          , Xu          , Xu          , Xu          
Xu          , Xu          , Xu          , Xu          , Ur          , Xu          , Xu          , Xu          , Xu          , Xu          , Uue         , Uue         , Uue         , Uue         , Xu          , Ur          , Ur          , Uue         , Uue         , Uue         , Uue         , Ur          , Ur          , Xu          , Xu          , Xu          , Xu          , Xu          , Xu          , Xu          , Xu          , Xu          
Xu          , Xu          , Xu          , Ur          , Ur          , Ur          , Ur          , Ur          , Ur          , Ur          , Uue         , Uue         , Xu          , Xu          , Xu          , Xu          , Ur          , Ur          , Uue         , Ur          , Ur          , Uue         , Ur          , Ur          , Xu          , Xu          , Xu          , Xu          , Xu          , Xu          , Xu          , Xu          
Xu          , Xu          , Xu          , Ur          , Uue         , Uue         , Uue         , Uue         , Uue         , Uue         , Xu          , Xu          , Xu          , Xu          , Xu          , Xu          , Xu          , Ur          , Ur          , Ur          , Xu          , Uue         , Ur          , Ur          , Ur          , Xu          , Xu          , Xu          , Xu          , Xu          , Xu          , Xu          
Xu          , Xu          , Ur          , Ur          , Uue         , Uue         , Uue^Emf     , Uue         , Uue         , Ur          , Xu          , Xu          , Xu          , Xu          , Xu          , Xu          , Xu          , Ur          , Ur          , Xu          , Xu          , Uue         , Uue         , Ur          , Ur          , Ur          , Xu          , Xu          , Xu          , Xu          , Xu          , Xu          
Xu          , Xu          , Ur          , Ur          , Ur          , Uue         , Uue         , Uue         , Ur          , Ur          , Xu          , Xu          , Xu          , Xu          , Xu          , Xu          , Xu          , Ur          , Xu          , Xu          , Xu          , Xu          , Uue         , Ur          , Ur          , Xu          , Xu          , Xu          , Xu          , Xu          , Xu          , Xu          
Xu          , Xu          , Xu          , Ur          , Ur          , Ur          , Ur          , Ur          , Xu          , Xu          , Xu          , Xu          , Xu          , Xu          , Xu          , Xu          , Xu          , Xu          , Xu          , Xu          , Xu          , Xu          , Uue         , Ur          , Ur          , Xu          , Xu          , Xu          , Xu          , Xu          , Xu          , Xu          
Xu          , Xu          , Xu          , Xu          , Xu          , Xu          , Xu          , Xu          , Ur          , Xu          , Ur          , Xu          , Xu          , Xu          , Xu          , Xu          , Ur          , Xu          , Ur          , Xu          , Ur          , Ur          , Uue         , Ur          , Ur          , Xu          , Xu          , Xu          , Xu          , Xu          , Xu          , Xu          
Xu          , Xu          , Xu          , Xu          , Xu          , Xu          , Xu          , Xu          , Ur          , Ur          , Ur          , Ur          , Xu          , Xu          , Ur          , Ur          , Ur          , Ur          , Ur          , Ur          , Ur          , Ur          , Uue         , Uue         , Uue         , Ur          , Xu          , Xu          , Xu          , Xu          , Xu          , Xu          
Xu          , Xu          , Xu          , Xu          , Xu          , Xu          , Ur          , Ur          , Ur          , Ur          , Ur          , Ur          , Ur          , Ur          , Ur          , Ur          , Uue         , Uue         , Uue         , Ur          , Uue         , Uue         , Uue         , Uue         , Uue         , Ur          , Ur          , Ur          , Ur          , Xu          , Xu          , Xu          
Xu          , Xu          , Xu          , Xu          , Xu          , Xu          , Ur          , Ur          , Ur          , Ur          , Uue         , Uue         , Ur          , Ur          , Uue         , Uue         , Xu          , Xu          , Ur          , Uue         , Uue         , Uue         , Uue         , Uue         , Uue         , Uue         , Ur          , Xu          , Ur          , Xu          , Xu          , Xu          
Xu          , Xu          , Xu          , Xu          , Xu          , Ur          , Ur          , 1 Ur        , Ur          , Ur          , Uue         , Uue         , Uue         , Uue         , Xu          , Xu          , Xu          , Xu          , Ur          , Ur          , Uue         , Uue         , Uue         , Uue         , Uue         , Uue         , Ur          , Xu          , Ur          , Xu          , Xu          , Xu          
Xu          , Xu          , Xu          , Ur          , Ur          , Ur          , Ur          , Ur          , Ur          , Ur          , Ur          , Ur          , Xu          , Xu          , Xu          , Xu          , Xu          , Xu          , Xu          , Ur          , Ur          , Uue         , Ur          , Ur          , Ur          , Ur          , Xu          , Ur          , Xu          , Xu          , Xu          , Xu          
Xu          , Xu          , Xu          , Xu          , Ur          , Ur          , Ur          , Ur          , Xu          , Xu          , Xu          , Xu          , Xu          , Xu          , Xu          , Xu          , Xu          , Xu          , Xu          , Xu          , Xu          , Ur          , Xu          , Ur          , Ur          , Ur          , Xu          , Xu          , Xu          , Xu          , Xu          , Xu          
Xu          , Xu          , Xu          , Xu          , Xu          , Ur          , Xu          , Xu          , Xu          , Xu          , Xu          , Xu          , Xu          , Xu          , Xu          , Xu          , Xu          , Xu          , Xu          , Xu          , Xu          , Xu          , Xu          , Xu          , Xu          , Xu          , Xu          , Xu          , Xu          , Xu          , Xu          , Xu          
Xu          , Xu          , Xu          , Xu          , Xu          , Xu          , Xu          , Xu          , Xu          , Xu          , Xu          , Xu          , Xu          , Xu          , Xu          , Xu          , Xu          , Xu          , Xu          , Xu          , Xu          , Xu          , Xu          , Xu          , Xu          , Xu          , Xu          , Xu          , Xu          , Xu          , Xu          , Xu          
