border_size=1
usage=map

Rrc         , Rrc         , Rrc         , Rrc         , Rrc         , Rrc         , Rrc         , Rrc         , Rrc         , Rrc         , Rrc         , Rrc         , Rrc         , Rrc         , Rrc         , Rrc         , Rrc         , Gg          
Rrc         , Rrc         , Rrc         , Rrc         , Rrc         , Rr^Vhc      , Rrc         , Rrc         , Rrc         , Rrc         , Rr^Vhc      , Rrc         , Rrc         , Rrc         , Rrc         , Rrc         , Rrc         , Gg          
Rrc         , Rrc         , Rrc         , Rrc         , Rrc         , Rrc         , Rr^Vhc      , Rrc         , Rr^Vhc      , Rrc         , Rrc         , Rrc         , Rrc         , Rrc         , Rrc         , Rrc         , Rrc         , Gg          
Rrc         , Rrc         , Rrc         , Rrc         , Rrc         , Rrc         , Rrc         , Rrc         , Rrc         , Rrc         , Rrc         , Rr^Vhc      , Rp^Vhcr     , Rp^Vhcr     , Rrc         , Rrc         , Rp^Vhcr     , Gg          
Rrc         , Rrc         , Rrc         , Rr^Vhc      , Rrc         , Rrc         , Rrc         , Rrc         , Rrc         , Rrc         , Rrc         , Rp^Vhcr     , Rrc         , Rrc         , Rrc         , Rp^Vhcr     , Ch          , Gg          
Ch          , Rrc         , Rrc         , Rrc         , Rrc         , Rrc         , Rrc         , Rrc         , Rrc         , Rr^Vhc      , Rrc         , Rrc         , Rrc         , Rrc         , Ch          , Ch          , Xv          , Gg          
Xv          , Ch          , Ch          , Rrc         , Rrc         , Rrc         , Mm          , Rrc         , Rrc         , Rrc         , Rrc         , Rrc         , Ch          , Ch          , Xv          , Xv          , Xv          , Gg          
Xv          , Xv          , Xv          , Ch          , Ch          , Ch          , Ch          , Rr          , Ch          , 2 Rrc       , Ch          , Ch          , Xv          , Xv          , Xv          , Xv          , Wo          , Gg          
Wo          , Xv          , Xv          , Xv          , Xv          , Xv          , Xv          , Rr          , Wo          , Ch          , Xv          , Xv          , Xv          , Xv          , Wo          , Wo          , Wo          , Gg          
Wo          , Wo          , Wo          , Xv          , Xv          , Xv          , Wo          , Wo^Bw|      , Wo          , Xv          , Xv          , Xv          , Wo          , Wo          , Wo          , Wo          , Gs^Fds      , Gg          
Wo          , Wo          , Wo          , Wo          , Wo          , Wo          , Ch          , Ww^Bw|      , Ch          , Wo          , Wo          , Wo          , Ww          , Ww          , Ww          , Gs^Fds      , Gs^Fds      , Gg          
Wo          , Wo          , Gg          , Gg          , Gg          , Gg          , Gs^Fp       , Rr          , Rr          , Ww          , Gg          , Wo          , Ww          , Ww          , Ww          , Gs^Fds      , Gs^Fds      , Gg          
Gs^Fp       , Gg          , Gg          , Gg          , Gg          , Gg          , Gs^Fp       , Rr          , Rr          , Ww          , Gg          , Gs^Fds      , Ww          , Ww          , Ww          , Gs^Fds      , Gs^Fds      , Gg          
Gg          , Gg          , Gg          , Gg          , Gs^Fp       , Gg          , Gg          , Rr          , Rr          , Ww          , Gg          , Gs^Fds      , Ww          , Ww          , Gs^Fds      , Gs^Fds      , Gs^Fds      , Gg          
Hh          , Gg          , Gs^Fp       , Gs^Fp       , Gs^Fp       , 1 Gg        , Rr          , Rr          , Rr          , Ww          , Gg          , Gs^Fds      , Gd          , Gs^Fds      , Gs^Fds      , Gs^Fds      , Gs^Fds      , Gg          
Hh          , Hh          , Gs^Fp       , Gs^Fds      , Gs^Fds      , Gs^Fds      , Rr          , Gg          , Rr          , Gd          , Gd          , Gd          , Gd          , Gs^Fds      , Gs^Fds      , Gs^Fds      , Gs^Fds      , Gg          
Hh          , Hh          , Hh          , Gs^Fds      , Gd          , Gs^Fds      , Gg          , Gg          , Rr          , Gd          , Gd          , Gd          , Gd          , Gs^Fds      , Gs^Fds      , Gs^Fds      , Gs^Fds      , Gg          
