border_size=1
usage=map

Ss          , Ss          , Ss          , Ww          , Ww          , Ww          , Wo          , Wo          , Wo          , Gg          , Gg          , Gg          , Gg          , Gg          , Ss          , Ss          , Ss          , Ww          , Ss          , Gg          , Ss          , Gg          , Ss          , Hh          , Mm          , Mm          , Mm          , Mm          , Mm          , Mm          , Mm          , Mm          , Mm          , Ss          , Gg          , Ss          , Ss          , Ss          , Ss          , Ss          , Ss          , Ss          , Ss          , Ss          , Ss          , Ss          , Ss          , Ss          , Ss          , Ss          , Ss          , Ss          
Ss          , Ss          , Ss          , Ss          , Ww          , Ww          , Ww          , Wo          , Wo          , Wo          , Ss          , Ss          , Ss          , Ss          , Ss          , Ss          , Ss          , Ss          , Gs^Fp       , Ss          , Ss          , Ss          , Hh          , Mm          , Mm          , Mm          , Mm          , Mm          , Mm          , Mm          , Mm          , Mm          , Mm          , Hh          , Hh          , Ss          , Ss          , Ss          , Wwg         , Ss^Vhs      , Re          , Re          , Ss          , Ss          , Ss          , Ss          , Ss          , Ss          , Ss          , Ss          , Ss          , Ss          
Gs^Fp       , Gs^Fp       , Gs^Fp       , Gs^Fp       , Gs          , Gs          , Ww          , Ww          , Wo          , Wo          , Ss          , Ss          , Gs^Fp       , Ss          , Gs^Fp       , Gs^Fp       , Gs^Fp       , Gs^Fp       , Gs^Fp       , Gs^Fp       , Gs^Fp       , Ss          , Hh          , Hh          , Hh          , Hh          , Hh          , Hh          , Mm          , Mm          , Mm          , Mm          , Mm          , Hh          , Hh          , Ss          , Wwg         , Wwg         , Chw         , Ss          , Wwg         , Ss          , Ss          , Ss          , Gs^Fdw      , Gs^Fdw      , Ss          , Ss          , Ss          , Ss          , Ss          , Ss          
Gs^Fp       , Gs^Fp       , Gs^Fp       , Gs          , Gs          , 1 Gs        , Gs          , Ww          , Wo          , Wo          , Gs^Fp       , Gs^Fp       , Gg^Ve       , Gs^Fp       , Gs^Fp       , Gs^Fp       , Gs^Fp       , Gs^Fp       , Ss          , Ss          , Ss          , Ss          , Ss          , Hh          , Ss          , Ss          , Gg          , Hh          , Hh          , Mm          , Mm          , Mm          , Mm          , Hh          , Ss          , Wwg         , Chw         , Chw         , Chw         , Wwg         , Ss          , Ss          , Ss          , Ss          , Gs^Fdw      , Gs^Fdw      , Ss          , Ss          , Ss          , Gs^Fdw      , Gs^Fdw      , Ss          
Gs^Fp       , Gs^Fp       , Gs^Fp       , Gs          , Gs          , Gs          , Ww          , Ww          , Wo          , Wo          , Gs^Fp       , Gs^Fp       , Gs^Fp       , Gs^Fp       , Gs^Fp       , Gs^Fp       , Re          , Re          , Re          , Re          , Re          , Re          , Re          , Ss          , Ww^Bw/      , Re          , Re          , Gg          , Gg          , Gg          , Hh          , Mm          , Hh          , Hh          , Ss          , Wwg         , Chw         , 3 Khw       , Wwg         , Wwg         , Ss          , Ss          , Ss          , Ss          , Ss          , Ss          , Ss          , Ss          , Ss          , Gs^Fdw      , Ss          , Ss          
Gs^Fp       , Gs^Fp       , Gs^Fp       , Gs          , Gs          , Gs          , Ww          , Ww          , Wo          , Wo          , Gs^Fp       , Ss          , Gs^Fp       , Gs^Fp       , Re          , Ww^Bw/      , Gs^Fp       , Ss          , Ss          , Hh          , Mm          , Hh          , Hh          , Re          , Ss          , Ss          , Ss          , Re          , Ss          , Ss          , Ss          , Ss          , Ss          , Ss          , Ss          , Wwg         , Wwg         , Chw         , Ss          , Ss          , Gs^Fdw      , Gs^Fdw      , Ss^Vm       , Ss          , Ss          , Ss          , Ss          , Ss          , Gs^Fdw      , Ss          , Ss          , Ss          
Gg          , Re          , Re          , Gs          , Gs          , Gs          , Ww          , Ww          , Wo          , Ww          , Ss          , Ss          , Ss          , Re          , Ss          , Ss          , Ss          , Ss          , Hh          , Hh          , Mm          , Mm          , Hh          , Ss          , Ss          , Gs^Fp       , Ww          , Re          , Ss          , Ss          , Gs^Fp       , Ss          , Ss          , Ss          , Ww^Bw/      , Wwg         , Ss          , Ss          , Ss          , Ss          , Ss          , Gs^Fdw      , Ss          , Ss          , Ss          , Ss          , Ss^Vm       , Gs^Fdw      , Gs^Fdw      , Ss          , Ss          , Ss          
Gg          , Gg          , Gs          , Gg          , Gs^Vh       , Gs^Fp       , Ww          , Wo          , Ww          , Gs^Fp       , Ss          , Ss          , Re          , Re          , Ss          , Ss          , Ss          , Hh          , Hh          , Mm          , Mm          , Mm          , Mm          , Ss          , Ss          , Gs^Fp       , Gs^Fp       , Re          , Re          , Re          , Re          , Re          , Re          , Re          , Ss          , Ss          , Ss          , Ss          , Ss          , Ss          , Ss          , Ss          , Ss          , Ss^Vm       , Ss          , Ss          , Ss          , Gs^Fdw      , Ss          , Ss          , Ss          , Ss          
Gg          , Gg          , Gs          , Re          , Rr          , Re          , Ww^Bw\      , Wo          , Ss          , Ss          , Re          , Re          , Ss          , Ss          , Ss          , Ss          , Ss          , Mm          , Mm          , Mm          , Mm          , Mm          , Mm          , Mm          , Ss          , Gs^Fp       , Gs^Fp       , Gs^Fp       , Gs^Fp       , Gs^Fp       , Gs^Fp       , Ss^Vhs      , Ww^Bw|      , Ss          , Gs^Fp       , Gs^Fp       , Ss          , Gs^Fp       , Re          , Ss          , Re          , Re          , Re          , Ss          , Ss          , Ss          , Ss          , Ss          , Ss          , Ss          , Re          , Re          
Gg          , Gs^Vh       , Gs          , Rr^Vhc      , Rr^Vhc      , Rr          , Rr          , Re          , Gs          , Ww^Bw/      , Gs^Vl       , Gg          , Ss          , Ss          , Ss          , Ss          , Ss          , Mm          , Mm          , Mm          , Mm          , Mm          , Mm          , Mm          , Ss          , Ss          , Gs^Fp       , Gs^Fp       , Gs^Fp       , Gs^Fp       , Gs^Fp       , Ss          , Ww^Bw|      , Ss          , Ss          , Ss          , Re          , Re          , Ss          , Re          , Hhd         , Ww          , Hhd         , Re          , Re          , Ss          , Ss          , Ss          , Re          , Re          , Ss          , Ss          
Mm          , Re          , Gg          , Gg          , Gg          , Gg          , Rr          , Rr          , Rr          , Rr          , Rr^Vhc      , Gg          , Gg          , Hh          , Hh          , Ss          , Hh          , Hh          , Mm          , Mm          , Mm          , Hh          , Hh          , Hh          , Ww          , Ss          , Gs^Fp       , Gs^Fp       , Gs^Fp       , Ss          , Ss          , Ss          , Re          , Gg          , Re          , Re          , Gg          , Ss          , Hhd         , Hhd         , Ww          , Ww          , Hhd         , Ss          , Ss          , Re          , Re          , Re          , Ss          , Ss          , Sm          , Ss          
Re          , Re          , Hh          , Gg          , Gg          , Gg          , 2 Rr        , Rr          , Rr          , Rr^Vhc      , Gd^Vhr      , Gs^Vl       , Hh          , Hh          , Hh          , Hh          , Hh          , Hh          , Hh          , Gg          , Hh          , Gg          , Ww          , Ww          , Ss          , Ww          , Ww          , Ww          , Ss          , Ss          , Ss          , Gg          , Gg          , Re          , Re          , Ww          , Ww          , Gg          , Hhd         , Hhd^Vhhr    , Ww          , Gd^Vhr      , Ss          , Ss          , Ss          , Ss          , Ss          , Ss          , Sm          , Sm          , Sm          , Sm          
Mm          , Mm          , Mm          , Hh          , Gg          , Gs^Vh       , Gs^Vh       , Hh^Vhh      , Gs^Vh       , Rr^Vhc      , Hh          , Mm          , Hh          , Hh          , Hh          , Hh          , Hh          , Ss          , Ss          , Ss          , Gg          , Gg^Ve       , Ww          , Ss          , Ss          , Ww          , Ss          , Ww          , Ww          , Ss          , Ss          , Ss          , Ww          , Ss          , Re          , Ww          , Ss          , Ww          , Ww          , Ww          , Ww          , Ss          , Ss          , Ss          , Ss^Vm       , Ss          , Ss^Vhs      , Ss          , Sm          , Sm          , Sm          , Sm          
Mm          , Mm          , Mm          , Mm          , Hh          , Gg          , Gg          , Hh^Vhh      , Hh          , Mm          , Mm          , Mm          , Mm          , Mm          , Hh          , Hh          , Hh          , Ss          , Ss          , Ss          , Ww          , Ww          , Ww          , Ss          , Ss          , Ss          , Ss          , Ss          , Ss          , Ww          , Ww          , Ww          , Ss          , Ww          , Ww          , Re          , Ss          , Ss          , Ss          , Ww          , Ss          , Sm          , Sm          , Ss          , Ss          , Ss^Vhs      , Gs^Fdw      , Gs^Fdw      , Gs^Fdw      , Sm          , Ss          , Sm          
Mm          , Mm          , Mm          , Mm          , Mm          , Hh          , Hh          , Hh          , Mm          , Mm          , Mm          , Mm          , Mm          , Mm          , Mm          , Hh          , Hh          , Ss          , Ww          , Ww          , Ss          , Ss          , Ss          , Ss          , Ss          , Ss          , Ss          , Ss          , Ss          , Ww          , Ww          , Ss          , Ss          , Ss          , Gg          , Re          , Ss          , Ss          , Ss          , Ss          , Sm          , Sm          , Sm          , Sm          , Ss          , Ss          , Ss          , Gs^Fdw      , Gs^Fdw      , Ss          , Ss          , Ss          
Mm          , Mm          , Mm          , Mm          , Mm          , Mm          , Mm          , Mm          , Mm          , Mm          , Mm          , Mm          , Mm          , Mm          , Mm          , Mm          , Mm          , Ww          , Ww          , Ss          , Ss          , Ss          , Ss          , Ss          , Ss          , Ss          , Ss          , Ss          , Ss          , Ss          , Ss          , Ss          , Ss          , Ss          , Gg          , Re          , Re          , Ss          , Ss          , Ss          , Ss          , Ss          , Ss          , Sm          , Ss          , Ss          , Ss          , Ss          , Ss          , Ss          , Ss          , Ss          
Mm          , Mm          , Mm          , Mm          , Mm          , Mm          , Mm          , Mm          , Mm          , Mm          , Mm          , Mm          , Mm          , Ww          , Ww          , Mm          , Ww          , Ww          , Ss          , Ss          , Ss          , Ss          , Ss          , Ss          , Ss          , Ss          , Ss          , Gs^Fp       , Gg^Ve       , Ww          , Wo          , Ww          , Ww          , Ww          , Ww          , Ss          , Ss          , Re          , Ss          , Gs^Fdw      , Gs^Fdw      , Ss          , Ww          , Ww          , Ww          , Ss          , Ss          , Ss          , Ss          , Ss          , Ss          , Ss          
Mm          , Mm          , Mm          , Mm          , Mm          , Mm          , Mm          , Mm          , Mm          , Mm          , Hh          , Mm          , Mm          , Ww          , Mm          , Ww          , Ww          , Ww          , Ss          , Ss          , Ss          , Ss          , Ss          , Ss          , Ss          , Ss          , Ss          , Gs^Fp       , Gs^Fp       , Ww          , Wo          , Wo          , Wo          , Wo          , Ww          , Ss          , Re          , Re          , Ss          , Ss          , Ss          , Ss          , Ww          , Chw         , Chw         , Ww          , Ss          , Ss          , Gs^Fdw      , Gs^Fdw      , Gs^Fdw      , Ss          
Mm          , Mm          , Mm          , Mm          , Mm          , Mm          , Mm          , Mm          , Hh          , Hh          , Ss          , Hh          , Hh          , Hh          , Mm          , Mm          , Ww          , Ww          , Ss          , Ss          , Ss          , Gs^Fp       , Gs^Fp       , Gs^Fp       , Ss          , Ss          , Ss          , Ss          , Ss          , Ww          , Wo          , Wo          , Wo          , Wo          , Ww          , Ww          , Ww^Bw|      , Ss          , Ss          , Ss          , Ss          , Ww          , Ww          , Ww          , 4 Khw       , Chw         , Ww          , Ss          , Ss          , Gs^Fdw      , Ss          , Ss          
Mm          , Mm          , Mm          , Mm          , Mm          , Mm          , Mm          , Hh          , Ss          , Ss          , Ss          , Ss          , Ss          , Ss          , Hh          , Hh          , Hh          , Hh          , Ss          , Gs^Fp       , Gs^Fp       , Gs^Fp       , Gs^Fp       , Gs^Fp       , Ss          , Ss          , Ss          , Ss          , Ss          , Ss          , Ww          , Wo          , Wo          , Wo          , Ww          , Ss          , Ww^Bw|      , Ss          , Ss          , Ss          , Ss          , Ss          , Ww          , Chw         , Chw         , Chw         , Ss          , Ss          , Ss          , Ss          , Gs^Fdw      , Ss          
Hh          , Hh          , Mm          , Mm          , Mm          , Mm          , Mm          , Hh          , Ss          , Ss          , Ss          , Ss          , Ss          , Ss          , Ss          , Ss          , Ss          , Ss          , Gs^Fp       , Gs^Fp       , Gs^Fp       , Gs^Fp       , Gs^Fp       , Gs^Fp       , Gs^Fp       , Gs^Fp       , Gs^Fp       , Gs^Fp       , Gs^Fp       , Gs^Fp       , Ww          , Ww          , Wo          , Wo          , Ss          , Ss          , Ch          , Ss          , Gs^Fp       , Ss          , Ss          , Ss          , Ss          , Ww          , Ss          , Ww          , Ss          , Ss          , Ss          , Gs^Fdw      , Gs^Fdw      , Gs^Fdw      
Gs^Fp       , Hh          , Hh          , Hh          , Hh          , Hh          , Ss          , Ss          , Ss          , Ss          , Ss          , Ss          , Ss          , Gs^Fp       , Gs^Fp       , Gs^Fp       , Gs^Fp       , Gs^Fp       , Gs^Fp       , Gs^Fp       , Ww          , Gs^Fp       , Gs^Fp       , Gs^Fp       , Gs^Fp       , Gs^Fp       , Gs^Fp       , Gs^Fp       , Gs^Fp       , Ss          , Ww          , Ww          , Ww          , Ww          , Gs^Fp       , Gs^Fp       , Ss          , Ss          , Ss          , Ss          , Ss          , Ss          , Ss          , Ss          , Ss          , Ss          , Ss          , Ss          , Ss          , Gs^Fdw      , Gs^Fdw      , Gs^Fdw      
