border_size=1
usage=map

Gg          , Gg          , Gg          , Gs^Fp       , Ss          , Ss          , Ss          , Gg          , Ss          , Ss          , Hh          , Hh          , Hh          , Ww          , Hh          , Ss          , Gg          , Gg          , Ww          , Ww          , Ww          , Ww          , Ww          , Gg          , Gg          , Ss          , Ss          , Ss          , Wwf         , Ww          , Ww          , Ss          , Ss          , Ww          , Ww          , Ww          , Ww          , Wo          , Ww          , Gs^Fp       , Ss          , Ss          , Ss          , Ss          , Hh          , Ww          , Ss          , Ww          , Ww          , Ww          , Ww^Bw\      , Ss          
Gg          , Gg          , Gg          , Gg          , Gg          , Gg          , Gg          , Gg          , Ss          , Gs^Fp       , Ss          , Hh          , Hh          , Mm          , Hh          , Ss          , 7 Ww^Kov    , Ww^Cov      , Ww^Cov      , Ww          , Wwg         , Ww          , Gg          , Gg          , Gg          , Ss          , Ss          , Chw         , Chw         , Wwf         , Ww          , Ss          , Ww          , Ww          , Ww          , Ww          , Ww          , Wo          , Ww          , Ww          , Gs^Fp       , Ss          , Ss          , Hh          , Ww          , Ww          , Ww          , Ss          , Gg          , Ss          , Ww          , Re          
Rrc         , Gg          , Gg          , Gg          , Gg          , Gg          , Gg          , Gg          , Gg          , Gs^Fp       , Gs^Fp       , Ss          , Hh          , Hh          , Ss          , Ww^Cov      , Ww^Cov      , Ww^Cov      , Ww          , Ww          , Wwg         , Ww          , Ss          , Gg          , Gg          , Gg          , Ss          , Chw         , 3 Khw       , Chw         , Wwf         , Ww          , Ww          , Ww          , Ww          , Wo          , Ww          , Ww          , Ww          , Gs^Fp       , Gs^Fp       , Ss          , Ss          , Ss          , Hh          , Hh          , Ss          , Ss          , Ss          , Ss          , Gg          , Re          
Gg          , Rrc         , Rrc         , Gg          , Gg          , Gg          , Gg          , Gg          , Gg          , Gg          , Gs^Fp       , Ss          , Ss          , Ss          , Ss          , Ww          , Wwg         , Ww          , Wwg         , Wwg         , Wwg         , Ww          , Ss          , Gg          , Gg          , Gg          , Hh          , Chw         , Ss          , Chw         , Ss          , Ss^Vhs      , Ww          , Ww          , Wo          , Ww          , Gs^Fp       , Gs^Fp       , Gs^Fp       , Gs^Fp       , Ss          , Ss          , Ss          , Ss          , Ss          , Hh          , Hh          , Ss          , Ss          , Ss          , Ss          , Re          
Ww          , Gg          , Gg          , Rrc         , Rrc         , Gg          , Gg          , Gg          , Gg          , Gg          , Ss          , Ss          , Ss          , Ss          , Ss          , Ww          , Wwg         , Wwg         , Ss          , Wwg         , Ww          , Ww          , Ss          , Gg          , Gg          , Hh          , Hh          , Hh          , Ss          , Ss          , Ss          , Ww          , Wo          , Wo          , Ww          , Ss          , Ss          , Gs^Fp       , Ss          , Ss          , Ss          , Ss          , Ss          , Ss          , Ss          , Ss          , Ss          , Ss          , Ss          , Gg          , Gg          , Gg          
Ww          , Gg          , Gg          , Gg          , Gg          , Rrc         , Rrc         , Ss          , Ch          , Ch          , Ch          , Gg          , Ww          , Ss          , Ss          , Ss          , Ss          , Ss          , Ss          , Ss          , Ss          , Ww          , Ww          , Ss          , Gg          , Hh          , Hh          , Hh          , Ww          , Ss          , Ss          , Ss          , Wo          , Wo          , Ww          , Ss          , Ss          , Ss          , Ss          , Ss          , Ss          , Ss          , Ww          , Ww          , Ss          , Ss          , Ss          , Ss          , Ss          , Gg          , Ww          , Ww          
Ww          , Ww          , Ww          , Gg          , Gg          , Gg          , Gg          , Rrc         , Ch          , 1 Kh        , Ch          , Gg          , Ww          , Ss          , Ss          , Ss          , Ss          , Ss          , Ss          , Ss          , Ss          , Ww          , Ww          , Ww          , Ww          , Hh          , Ww          , Ww          , Hh          , Ww          , Ww          , Gs^Fp       , Ww          , Wo          , Ww          , Gs^Fp       , Ss          , Ss          , Ss          , Gg          , Gg          , Gg^Ve       , Ww          , Wwg         , Ww          , Ww          , Ww          , Ww          , Ww          , Wwg         , Wwg         , Wwg         
Wwg         , Wwg         , Wwg         , Ww          , Ww          , Ww          , Ww          , Ss          , Gs^Fp       , Ch          , Rr          , Gg          , Ww          , Ss          , Ss          , Ss          , Ss          , Ss          , Ss          , Ss          , Ss          , Ss          , Ss          , Ww          , Ww          , Ww          , Ww          , Hh^Fp       , Hh^Fp       , Ss          , Ww          , Gs^Fp       , Ww          , Wo          , Ww          , Gs^Fp       , Gs^Fp       , Ss          , Ss          , Gg          , Gg          , Gg          , Ww          , Wwg         , Wwg         , Wwg         , Wwg         , Wwg         , Wwg         , Wwg         , Wwg         , Wwg         
Wwg         , Wwg         , Wwg         , Wwg         , Wwg         , Wwg         , Ww          , Ss          , Gs^Fp       , Rr          , Rr          , Gg          , Ww          , Ss          , Gll         , Gll         , Gll         , Ss          , Ss          , Ss          , Ss          , Ss          , Sm          , Ss          , Ss          , Sm          , Hh          , Hh          , Hh^Fp       , Hh          , Ww          , Ww          , Gs^Fp       , Ww          , Ww          , Gs^Fp       , Gs^Fp       , Gs^Fp       , Gs^Fp       , Ss          , Gg          , Gg          , Ww          , Wwg         , Wwg         , Wwg         , Ww          , Ww          , Ww          , Ww          , Gg          , Wwg         
Wwg         , Wwg         , Wwg         , Wwg         , Wwg         , Wwg         , Ww          , Ss          , Ss          , Ss          , Rr          , Gg          , Ww          , Ss          , Gll         , Gll         , Gs^Fms      , Gll         , Gll         , Ss          , Ss          , Ss          , Sm          , Ss          , Gs^Fp       , Sm          , Ss          , Hh          , Hh^Fp       , Hh          , Ss          , Ss          , Gs^Fp       , Gs^Fp       , Ww          , Ww          , Gs^Fp       , Gs^Fp       , Gs^Fp       , Ss          , Gg          , Ww          , Ww          , Ww          , Ww          , Ww          , Gs          , Gs          , Gg          , Gs          , Gs          , Gs          
Wwg         , Wwg         , Wwg         , Wwg         , Wwg         , Wwg         , Wwg         , Ww          , Ww          , Ww          , Rr          , Ww          , Ss          , Ss          , Gll         , Gs^Fms      , Gs^Fds      , Gs^Fms      , Gs^Fms      , Gll         , Gll         , Ss          , Sm          , Ss          , Ss          , Ss          , Ss          , Gg          , Hh          , Hh^Fp       , Hh^Fp       , Ss          , Ss          , Gs^Fp       , Ww          , Ww          , Ww          , Ww          , Ww          , Ww          , Ww          , Gs          , Gs          , Gs          , Gs          , Gs          , Ce          , Gs          , Gs          , Gs          , Ss          , Ss          
Wwg         , Wwg         , Wwg         , Wwg         , Wwg         , Wwg         , Wwg         , Wwg         , Wwg         , Ww          , Ss          , Rr          , Rr          , Ss          , Gll         , Gs^Fms      , Gs^Fms      , Gs^Fds      , Gs^Fds      , Gs^Fms      , Ss          , Ss          , Ww          , Gg          , Ss          , Ss          , Ss          , Ss          , Ss          , Hh          , Hh^Fp       , Hh^Fp       , Ss          , Gs^Fp       , Ww          , Ww          , Ww          , Ww          , Ww          , Ww          , Gs          , Gg          , Gg          , Gs          , Gs          , Ce          , 4 Ket       , Ce          , Ww          , Ss          , Ss          , Ss          
Wwg         , Wwg         , Wwg         , Wwg         , Wwg         , Wwg         , Wwg         , Wwg         , Wwg         , Ww          , Ss          , Ss          , Ss          , Rr          , Rr          , Gll         , Gs^Fms      , Gs^Fms      , Gs^Fms      , Gs^Fms      , Ss          , Ss          , Ww          , Ww          , Gg          , Gg          , Ss          , Ss          , Ss          , Ss          , Ss          , Ss          , Ss          , Gs^Fp       , Ww          , Ww          , Ww          , Ww          , Ww          , Ww          , Gs          , Gs          , Gg          , Gg          , Gs          , Ce          , Gs          , Ce          , Ss          , Ss          , Ss          , Ss          
Wwg         , Wwg         , Wwg         , Wwg         , Wwg         , Wwg         , Wwg         , Ww          , Ww          , Ww          , Wwg         , Ss          , Ss          , Ss          , Ss          , Rr          , Gs^Fms      , Gs^Fds      , Gs^Fds      , Gs^Fms      , Ss          , Ss          , Ss          , Ww          , Ww          , Gg          , Ss          , Ss          , Gs^Fp       , Ww          , Gs^Fp       , Gs^Fp       , Gs^Fp       , Gs^Fp       , Ww          , Ww          , Ww          , Ww          , Ww          , Ww          , Ww          , Gs          , Gs          , Gg          , Gs          , Ce          , Ce          , Ce          , Ss          , Ss          , Ss          , Ss          
Wwg         , Wwg         , Wwg         , Wwg         , Wwg         , Wwg         , Ww          , Ww          , Ww          , Ww          , Gs^Fp       , Ss          , Ss          , Ss          , Ss          , Rr          , Gs^Fms      , Gs^Fms      , Gs^Fds      , Gs^Fms      , Ss          , Ss          , Ss          , Ss          , Ww          , Ww          , Ww          , Ww          , Ww          , Ww          , Ss          , Ww          , Ww          , Ww          , Ww          , Ww          , Ww          , Ww          , Gg          , Gg          , Ww          , Gs          , Ss          , Gs          , Ss          , Gs          , Ss          , Gs          , Ss          , Ss          , Ss          , Ss          
Wwg         , Wwg         , Wwg         , Wwg         , Wwg         , Ww          , Ss          , Ww          , Ww          , Ww          , Ww          , Ss          , Ss          , Ss          , Ss          , Rr          , Rr          , Gs^Fms      , Gs^Fms      , Gs^Fms      , Gs^Fms      , Ss          , Sm          , Ww          , Ww          , Ww          , Ww          , Wwg         , Ss          , Ss          , Ww          , Ww          , Ww          , Ww          , Ww          , Ww          , Ss          , Ss          , Gg          , Gg          , Ww          , Ss          , Ss          , Ss          , Ss          , Ss          , Ss          , Ss          , Ss          , Ss          , Ss          , Ss          
Wwg         , Wwg         , Wwg         , Wwg         , Wwg         , Ww          , Ss          , Ss          , Ss          , Ww          , Ss          , Ww          , Wwg         , Ss          , Wwg         , Ss          , Ss          , Rr          , Rr          , Gs^Fms      , Gs^Fms      , Ss          , Sm          , Ss          , Gg          , Gg          , Ww          , Ss          , Ss          , Ss          , Ww          , Ww          , Ww          , Ww          , Ww          , Ss          , Ss          , Gs          , Gs          , Gg          , Ww          , Gg^Ve       , Ww          , Ss          , Sm          , Ss          , Ss          , Ww          , Ss          , Ss          , Ss          , Ss          
Wwg         , Wwg         , Wwg         , Wwg         , Wwg         , Ww          , Ss          , Ss          , Hh          , Gg          , Ss          , Ww          , Ww          , Wwg         , Wwg         , Wwg         , Wwg         , Gll         , Rr          , Gll         , Gll         , Ss          , Sm          , Ss          , Gg          , Gg          , Ss          , Ss          , Ww          , Ww          , Ss          , Ss          , Ss          , Ww          , Ww          , Ss          , Ss          , Gg          , Gg          , Gg          , Ww          , Ss          , Ww          , Ss          , Sm          , Sm          , Sm          , Ww          , Ww          , Ss          , Gs^Fp       , Ww          
Wwg         , Wwg         , Wwg         , Wwg         , Wwg         , Ww          , Gs^Fp       , Ss          , Ss          , Gg          , Ss          , Ss          , Ww          , Ww          , Ww          , Ww          , Ww          , Wwg         , Rr          , Gll         , Ss          , Ss          , Sm          , Sm          , Gg          , Gg          , Ww^Vm       , Ww          , Ss          , Ss          , Ss          , Ss          , Ss          , Ww          , Ww          , Ss          , Ss          , Ww          , Ww          , Ww          , Ww          , Ss          , Ww          , Ss          , Ss          , Sm          , Sm          , Ss          , Ww          , Ww          , Gs^Fp       , Ww          
Wwg         , Wwg         , Wwg         , Wwg         , Wwg         , Ww          , Gs^Fp       , Ss          , Ss          , Gg          , Ss          , Ss          , Ww          , Ss          , Gs^Fp       , Gs^Fp       , Ss          , Ss          , Rr          , Sm          , Sm          , Ss          , Ss          , Ss          , Ss          , Ss          , Ww          , Ss          , Ww          , Ss          , Ss          , Ss          , Ss          , Ww          , Ww          , Ss          , Ss          , Ww          , Ww          , Gs          , Gs          , Ss          , Ww          , Ss          , Ss          , Sm          , Sm          , Sm          , Ss          , Ww          , Ww          , Ww          
Wwg         , Wwg         , Wwg         , Wwg         , Wwg         , Ww          , Ww          , Ss          , Ss          , Ss          , Ss          , Sm          , Sm          , Ww          , Ww          , Ss          , Ss          , Ss          , Rr          , Sm          , Sm          , Sm          , Ww          , Ww          , Ww          , Ww          , Ww          , Ss          , Ww          , Ww          , Ww          , Ss          , Ww          , Ww          , Ww          , Ss          , Ww          , Ww          , Ww          , Gs          , Gg          , Gg          , Ww          , Ss          , Ss          , Ss          , Ss          , Sm          , Ss          , Ss          , Ss          , Ss          
Wwg         , Wwg         , Wwg         , Wwg         , Wwg         , Wwg         , Ww          , Ss          , Ss          , Ss          , Ss          , Sm          , Sm          , Hh^Fp       , Hh^Fp       , Hh          , Hh          , Ss          , Rr          , Sm          , Sm          , Ww          , Ww          , Ww          , Ww          , Ww          , Ww          , Ww          , Ss          , Ww          , Ww          , Ww          , Ww          , Ww          , Ww          , Ww          , Gg          , Gg          , Ww          , Gg          , Gg          , Ss          , Ss          , Ss          , Ss          , Ss          , Ss          , Ss          , Ss          , Ss          , Ss          , Ss          
Wwg         , Wwg         , Wwg         , Wwg         , Wwg         , Wwg         , Ww          , Ss          , Ss          , Ss          , Ss          , Hh          , Hh^Fp       , Hh^Fp       , Hh          , Hh          , Rr          , Rr          , Gs^Fp       , Sm          , Ww          , Ww          , Ww          , Ww          , Ss          , Ww          , Ss          , Ww          , Ss          , Ss          , Ss          , Ww          , Ww          , Ww          , Ww          , Ww          , Gg          , Gg          , Ww          , Ww          , Ww          , Wwg         , Wwg         , Ss          , Ww          , Ww          , Ww          , Ww          , Ss          , Ww          , Ww          , Ww          
Wwg         , Wwg         , Wwg         , Wwg         , Wwg         , Wwg         , Ww          , Ss          , Gs^Fp       , Ss          , Hh          , Hh          , Hh^Fp       , Hh^Fp       , Hh          , Rr          , Ss          , Ww          , Ww          , Ww          , Ww          , Ww          , Ww          , Ss          , Ss          , Ss          , Ss          , Ww          , Ww          , Ww          , Ss          , Ss          , Ww          , Ss          , Gg          , Ww          , Ww          , Gg          , Ww          , Ww          , Wwg         , Wwg         , Ww          , Ss          , Ss          , Ss          , Gg          , Gg          , Gg          , Gg          , Rr          , Rr          
Wwg         , Wwg         , Wwg         , Wwg         , Ww          , Ww          , Ww          , Gs^Fp       , Gs^Fp       , Ss          , Ss          , Hh          , Hh          , Ss          , Ss          , Rr          , Ww          , Ww          , Ww          , Ww          , Ww          , Ww          , Ww          , Ss          , Ss          , Ss          , Ss          , Ww          , Ww          , Ww          , Ww          , Ww          , Ss          , Gg          , Ww          , Ww          , Ww          , Ww          , Rr          , Ww          , Ww          , Ww          , Ss          , Ss          , Ss          , Gg          , Gg          , Gg          , Rr          , Rr          , Ss          , Ss          
Wwg         , Wwg         , Ww          , Ww          , Chw         , Chw         , Chw         , Ss          , Gs^Fp       , Gs^Fp       , Gs^Fp       , Ss          , Ss          , Ss          , Gs^Fp       , Rr          , Gg^Ve       , Ww          , Ww          , Ww          , Ww          , Ww          , Ww          , Ss          , Ww          , Ss          , Ww          , Ww          , Ww          , Ww          , Ww          , Ss          , Ss          , Gg          , Ww          , Ww          , Rr          , Rr          , Gg          , Rr          , Rr          , Ww          , Ss          , Ss          , Gg          , Ch          , Ch          , Ch          , Ch          , Ss          , Hh          , Hh          
Wwg         , Wwg         , Ww          , Ww          , Ww          , Chw         , Chw         , Chw         , Ss          , Gs^Fp       , Gs^Fp       , Gs^Fp       , Gs^Fp       , Gs^Fp       , Sm          , Rr          , Rr          , Ww          , Gg          , Ww          , Ww          , Ww          , Ww          , Ww          , Ww          , Ww          , Ww          , Ww          , Ww          , Ww          , Ww          , Ss          , Ch          , Ww          , Rr          , Rr          , Hh          , Hh          , Gg          , Ss          , Ss          , Ch          , Ss          , Ss          , Rr          , Ch          , 2 Kh        , Ch          , Ch          , Ss          , Hh          , Mm          
Wwg         , Ww          , Ss          , Ss          , Ss          , Ss          , Ss          , 6 Khw       , Ss          , Ss          , Ss          , Ss          , Ss          , Ss          , Ss          , Ss          , Ss          , Rr          , Rr          , Gg          , Gg          , Gg          , Gg          , Ww          , Ch          , Ww          , Ww          , Ww          , Ww          , Ww          , Rr          , Rr          , Ww          , Ch          , Ss          , Hh          , Hh^Fp       , Hh          , Hh          , Ss          , Ss          , Ch          , Rr          , Rr          , Gg          , Ch          , Ch          , Ch          , Gg          , Ss          , Hh          , Hh          
Gg          , Gg^Ve       , Gg          , Gg          , Hh          , Hh          , Ss          , Ss          , Ss          , Ss          , Ss          , Ss          , Ss          , Ss          , Ss          , Hh^Fp       , Hh^Fp       , Ss          , Hh^Fp       , Rr          , Rr          , Gg          , Rr          , Rr          , Ww          , Ww^Bw\      , Ww^Bw\      , Ss          , Ww^Bw/      , Rr          , Ww          , Ww          , Ss          , Ww          , Ww          , Hh          , Ww          , Hh^Fp       , Hh^Fp       , Ss          , Ww          , Ss          , Gg^Ve       , Ss          , Gg          , Gg          , Gg          , Gg          , Gg          , Ss          , Ss          , Hh          
Gg          , Gg          , Gg          , Hh          , Mm          , Mm          , Hh          , Ss          , Gs^Fp       , Ss          , Ss          , Ss          , Ss          , Ss          , Hh^Fp       , Hh^Fp       , Hh^Fp       , Hh^Fp       , Hh^Fp       , Ss          , Gg          , Rr          , Ww          , Ww          , Ss          , Ww          , Ww          , Rr          , Ss          , Ss          , Ww          , Gg^Ve       , Ss          , Ss          , Ss          , Ww          , Hh          , Ww          , Hh          , Ww          , Ss          , Ww          , Ww          , Gg          , Ss          , Ss          , Gg          , Gg          , Ss          , Ss          , Ss          , Ss          
Gg          , Ss          , Hh          , Mm          , Mm          , Mm          , Mm          , Ss          , Gs^Fp       , Ss          , Ss          , Ss          , Ss          , Hh^Fp       , Hh^Fp       , Hh^Fp       , Hh^Fp       , Hh^Fp       , Hh^Fp       , Ww          , Ww^Bw/      , Re          , Ww          , Ww          , Ww          , Ww          , Ww          , Gs^Fp       , Ww          , Ww          , Ss          , Ss          , Ss          , Gs^Fp       , Gs^Fp       , Ss          , Ss          , Ww          , Gg          , Ss          , Ss          , Ww          , Wo          , Ss          , Ss          , Ss          , Ss          , Gg          , Wo          , Ww          , Gg          , Gg          
Ww          , Ss          , Hh          , Mm          , Mm          , Mm          , Mm          , Hh          , Gs^Fp       , Ss          , Ss          , Ss          , Hh^Fp       , Hh^Fp       , Ss          , Hh^Fp       , Ss          , Hh^Fp       , Ss          , Ww          , Ww          , Ww          , Ww          , Ww          , Ww          , Ss          , Ww          , Ww          , Gs^Fp       , Ss          , Ss          , Ss          , Ss          , Gs^Fp       , Gs^Fp       , Gs^Fp       , Ss          , Ww          , Gg          , Gg          , Ww          , Wo          , Wo          , Ss          , Ss          , Ss          , Ss          , Ss          , Wo          , Wo          , Wo          , Ww          
