border_size=1
usage=map

Gg          , Gg          , Gg^Edp      , Gg          , Gg^Edp      , Gg^Edp      , Xol         , Gg          , Xol         , Gg          , Xol         , Gg          , Xol         , Gg          , Xol         , Gg          , Xol         , Gg          , Xol         , Gg          , Xol         , Iwr         
Gg          , Gg^Edp      , Wwt         , Gg^Edp      , Gg          , Gg^Edp      , Gg          , Xol         , Xol         , Xol         , Xol         , Xol         , Iwr         , Xol         , Iwr         , Xol         , Iwr         , Xol         , Iwr         , Xol         , Iwr         , Iwr         
Wwt         , Wwt         , Gg^Efm      , Wwt         , Gg          , Gg          , Gg          , Xol         , Xol         , Xol         , Iwr         , Iwr         , Iwr         , Iwr         , Iwr         , Iwr         , Iwr         , Iwr         , Iwr         , Iwr         , Iwr         , Iwr         
Gg          , Gg^Es       , Gg^Efm      , Wwt         , Wwt         , Gg^Fet      , Gg          , Gg^Edpp     , Gg^Edpp     , Xol         , Iwr         , Iwr         , Iwr         , Iwr         , Iwr         , Iwr         , Iwr         , Iwr         , Iwr         , Iwr         , Iwr         , Iwr         
Gg          , Gg^Efm      , Wwt         , Wwt         , Gg^Fet      , Wwt         , Gg^Fet      , Gg          , Gg          , Xol         , Iwr         , Iwr         , Iwr         , Iwr         , Iwr         , Iwr         , Iwr         , Iwr         , Iwr         , Iwr         , Iwr         , Iwr         
Gg          , Gg^Em       , Wwt         , Wwt^Es      , Wwt         , Wwt         , Gg          , Gg^Em       , Gg^Edpp     , Iwr         , Iwr         , Iwr         , Iwr         , Iwr         , Iwr         , Iwr         , Xol         , Iwr         , Iwr         , Iwr         , Iwr         , Iwr         
Xol         , Gg          , Gg          , Wwt         , Gg          , Gg          , Gg^Fet      , Gg^Edpp     , Xol         , Xol         , Iwr         , Iwr         , Iwr         , Iwr         , Xol         , Xol         , Iwr         , Xol         , Xol         , Iwr         , Iwr         , Iwr         
Cud         , Xol         , Xol         , Gg          , Gg          , Gg          , Xol         , Xol         , Iwr         , Xol         , Iwr         , Iwr         , Iwr         , Xol         , Iwr         , Iwr         , Iwr         , Iwr         , Iwr         , Xol         , Iwr         , Iwr         
Cud         , Cud         , Cud         , Cud         , Gg          , Gg          , Iwr         , Iwr         , Iwr         , Xol         , Iwr         , Iwr         , Iwr         , Iwr         , Iwr         , Iwr         , Iwr         , Iwr         , Iwr         , Xol         , Iwr         , Iwr         
Cud         , Cud         , Kud         , Cud         , Iwr         , Iwr         , Iwr         , Iwr         , Iwr         , Xol         , Iwr         , Iwr         , Iwr         , Xol         , Iwr         , Iwr         , Iwr         , Iwr         , Iwr         , Xol         , Iwr         , Iwr         
Cud         , Cud         , Cud         , Cud         , Iwr         , Iwr         , Iwr         , Iwr         , Iwr         , Iwr         , Iwr         , Iwr         , Iwr         , Xol         , Xol         , Iwr         , Iwr         , Iwr         , Xol         , Xol         , Iwr         , Iwr         
Cud         , Cud         , Iwr         , Iwr         , Iwr         , Iwr         , Iwr         , Iwr         , Iwr         , Iwr         , Iwr         , Iwr         , Iwr         , Iwr         , Iwr         , Xol         , Xol         , Xol         , Iwr         , Iwr         , Iwr         , Iwr         
Iwr         , Iwr         , Iwr         , Iwr         , Iwr         , Iwr         , Iwr         , Iwr         , Iwr         , Xol         , Iwr         , Iwr         , Iwr         , Iwr         , Iwr         , Iwr         , Iwr         , Iwr         , Iwr         , Iwr         , Iwr         , Iwr         
Iwr         , Iwr         , Iwr         , Iwr         , Iwr         , Iwr         , Iwr         , Iwr         , Iwr         , Xol         , Iwr         , Iwr         , Iwr         , Iwr         , Iwr         , Iwr         , Iwr         , Iwr         , Iwr         , Iwr         , Iwr         , Iwr         
Iwr         , Iwr         , Iwr         , Iwr         , Iwr         , Iwr         , Iwr         , Iwr         , Xol         , Xol         , Iwr         , Iwr         , Iwr         , Iwr         , Iwr         , Iwr         , Xol         , Iwr         , Iwr         , Iwr         , Xol         , Xol         
Iwr         , Iwr         , Iwr         , Iwr         , Iwr         , Iwr         , Xol         , Xol         , Urb         , Iwr         , Iwr         , Iwr         , Iwr         , Iwr         , Xol         , Xol         , Urb         , Xol         , Xol         , Xol         , Rrc         , Rrc         
Iwr         , Iwr         , Iwr         , Iwr         , Xol         , Xol         , Xol         , Urb         , Urb         , Urb         , Urb         , Iwr         , Xol         , Xol         , Urb         , Urb         , Urb         , Urb         , Rrc         , Rrc         , Rrc         , Rrc         
Iwr         , Iwr         , Xol         , Xol         , Urb         , Urb         , Urb         , Urb         , Xol         , Urb         , Urb         , Urb         , Urb         , Xol         , Xol         , Urb         , Rrc         , Rrc         , Rrc         , Rrc         , Rrc         , Rrc         
Xol         , Xol         , Urb         , Urb         , Urb         , Urb         , Urb         , Urb         , Xol         , Xol         , Xol         , Urb         , Urb         , Urb         , Rrc         , Rrc         , Rrc         , Rrc         , Rrc         , Rrc         , Rrc         , Rrc         
Urb         , Urb         , Urb         , Urb         , Urb         , Urb         , Xol         , Xol         , Urb         , Urb         , Urb         , Xol         , Rrc         , Rrc         , Rrc         , Rrc         , Rrc         , Rrc         , Rrc         , Rrc         , Rrc         , Rrc         
Urb         , Urb         , Urb         , Urb         , Urb         , Xol         , Xol         , Urb         , Urb         , Urb         , Rrc         , Rrc         , Rrc         , Rrc         , Rrc         , Rrc         , 1 Rrc       , Rrc         , Rrc         , Rrc         , Rrc         , Rrc         
Urb         , Urb         , Urb         , Urb         , Urb         , Urb         , Xol         , Xol         , Rrc         , Rrc         , Rrc         , Rrc         , Rrc         , Rrc         , Rrc         , Rrc         , Rrc         , Rrc         , Rrc         , Rrc         , Rrc         , Rrc         
Urb         , Urb         , Urb         , Urb         , Xol         , Xol         , Rrc         , Rrc         , Rrc         , Rrc         , Rrc         , Rrc         , Rrc         , Rrc         , Rrc         , Rrc         , Rrc         , Rrc         , Rrc         , Rrc         , Rrc         , Rrc         
Urb         , Urb         , Xol         , Xol         , Rrc         , Rrc         , Rrc         , Rrc         , Rrc         , Rrc         , Rrc         , Rrc         , Rrc         , Rrc         , Rrc         , Rrc         , Rrc         , Rrc         , Rrc         , Rrc         , Rrc         , Rrc         
Xol         , Xol         , Rrc         , Rrc         , Rrc         , Rrc         , Rrc         , Rrc         , Rrc         , Rrc         , Rrc         , Rrc         , Rrc         , Rrc         , Rrc         , Rrc         , Rrc         , Rrc         , Rrc         , Rrc         , Rrc         , Rrc         
Rrc         , Rrc         , Rrc         , Rrc         , Rrc         , Rrc         , Rrc         , Rrc         , Rrc         , Rrc         , Rrc         , Rrc         , Rrc         , Rrc         , Rrc         , Rrc         , Rrc         , Rrc         , Rrc         , Rrc         , Rrc         , Rrc         
Rrc         , Rrc         , Rrc         , Rrc         , Rrc         , Rrc         , Rrc         , Rrc         , Rrc         , Rrc         , Rrc         , Rrc         , Rrc         , Rrc         , Rrc         , Rrc         , Rrc         , Rrc         , Rrc         , Rrc         , Rrc         , Rrc         
