border_size=1
usage=map

Gs^Fds      , Gs^Fds      , Gs^Fds      , Gs^Fds      , Gs^Fds      , Hh          , Gll^Fp      , Gll^Fp      , Gll^Fp      , Hh          , Gs^Fds      , Gs^Fds      , Gs^Fds      , Gs^Fds      , Gs^Fds      , Gs^Fds      , Gs^Fds      , Gs^Fds      , Gs^Fds      , Gs          , Gg          , Gs          , Gs          , Gs          , Gll^Fp      , Gll^Fp      , Gll^Fp      , Gll^Fp      , Gll^Fp      , Gll^Fp      , Gll^Fp      , Gll^Fp      , Gs          , Rp          , Rp          , Gll^Fp      , Gg          , Gg          , Gs^Fp       , Gs^Fp       , Hh          , Hh          
Gll^Fmf     , Gs^Fds      , Gs^Fds      , Gs^Fds      , Gs^Fds      , Gs^Fds      , Hh          , Gll^Fp      , Gll^Fp      , Gll^Fp      , Gll^Fp      , Hh          , Gs^Fds      , Gs^Fds      , Gs^Fds      , Gs^Fds      , Gs^Fds      , Gs^Fds      , Gs          , Gs          , Gs          , Gs          , Gg          , Gs          , Gs          , Gll^Fp      , Gll^Fp      , Gll^Fp      , Gll^Fp      , Gll^Fp      , Gll^Fp      , Gll^Fp      , Gs          , Gs          , Rp          , Gg          , Rp          , Gg          , Gs^Fp       , Gs^Fp       , Gs^Fp       , Hh          
Gs          , Gll^Fmf     , Gll^Fmf     , Gs^Fds      , Gs^Fds      , Gs^Fds      , Gs^Fds      , Gll^Fp      , Gll^Fp      , Gll^Fp      , Gll^Fp      , Hh          , Gs^Fds      , Gs^Fds      , Gs^Fds      , Gs^Fds      , Gs^Fds      , Gs^Fds      , Gs^Fds      , Ha          , Gg          , Gg          , Gs          , Gs          , Gs          , Gs          , Gg          , Gll^Fp      , Gll^Fp      , Gll^Fp      , Gs          , Gg          , Gs          , Gs^Fp       , Gg          , Rp          , Gg          , Rp          , Gs^Fp       , Gg^Ve       , Gs^Fp       , Hh          
Gs          , Gs          , Gs          , Gll^Fmf     , Gs^Fds      , Gll^Fmf     , Gs^Fds      , Hh          , Gll^Fp      , Gll^Fp      , Hh          , Gll^Fp      , Hh          , Gs^Fds      , Gs^Fds      , Gs^Fds      , Gs^Fds      , Gs^Fds      , Gs^Fds      , Ha          , Ha          , Gs          , Rp          , Gg^Ve       , Rp          , Gg          , Gs          , Gg          , Gs          , Gs          , Gg          , Gs          , Gg          , Gs          , Gg          , Gg          , Gs^Fms      , Rp          , Gg          , Gs^Fp       , Gs^Fp       , Hh          
Gll^Fmf     , Gs          , Gll^Fmf     , Gs^Fds      , 9 Gs^Fds    , Gs^Fds      , Gll^Fmf     , Gs^Fds      , Gll^Fp      , Gll^Fp      , Gll^Fp      , Gll^Fp      , Hh          , Gs^Fds      , Gs^Fds      , Gs^Fds      , Gs^Fds      , Gs^Fds      , Gs^Fds      , Hh          , Rp          , Rp          , Hh          , Rp          , Hh          , Rp          , Rp          , Gs          , Gs          , Gs          , Gs          , Gs          , Rp          , Gg          , Gg          , Gs^Fms      , 4 Gs^Fms    , Rp          , Rp          , Gg          , Gg          , Gs^Fp       
Gs          , Gll^Fmf     , Gll^Fmf     , Gs^Fds      , Gs^Fds      , Gs^Fds      , Gs^Fds      , Gs^Fds      , Gll^Fp      , Gll^Fp      , Gll^Fp      , Gll^Fp      , Hh          , Gs^Fds      , Gs^Fds      , Gs^Fds      , Gs^Fds      , Gs^Fds      , Gll^Fp      , Rp          , Hh          , Hh          , Hh          , Hh          , Hh          , Hh          , Hh          , Rp          , Rp          , Rp          , Rp          , Rp          , Gll^Fp      , Rp          , Gll^Fp      , Gs^Fms      , Gs^Fms      , Gs^Fms      , Gs^Fms      , Rp          , Gg          , Hh          
Gll^Fmf     , Gll^Fmf     , Gs          , Gs^Fds      , Gs^Fds      , Gs^Fds      , Gs^Fds      , Gs^Fds      , Gll^Fp      , Gll^Fp      , Gll^Fp      , Hh          , Gg^Ve       , Hh          , Gs^Fds      , Hh          , Gll^Fp      , Gll^Fp      , Hh          , Hh^Fp       , Hh          , Hh          , Hh          , Hh          , Hh          , Hh          , Gll^Fp      , Rp          , Hh          , Hh          , Hh          , Gll^Fp      , Gll^Fp      , Gll^Fp      , Gg^Ve       , Gll^Fp      , Rp          , Rp          , Rp          , Rp          , Rp          , Hh          
Gll^Fp      , Gg          , Gll^Fp      , Gg          , Gll^Fp      , Gs^Fds      , Gll^Fp      , Gll^Fp      , Hh          , Gll^Fp      , Hh          , Hh          , Rp          , Rp          , Gll^Fp      , Gll^Fp      , Gs^Fds      , Hh          , Gs^Fds      , Hh^Fp       , Hh^Fp       , Hh          , Hh          , Hh          , Gll^Fp      , Gll^Fp      , Gll^Fp      , Hh          , Hh          , Hh          , Gs^Fds      , Gll^Fp      , Gll^Fp      , Gll^Fp      , Gs^Fds      , Gg          , Gg          , Gg          , Gg          , Rp          , Rp          , Rp          
Gs^Fds      , Gll^Fp      , Gs^Fds      , Gll^Fp      , Gg          , Gg          , Hh          , Hh          , Hh          , Gg^Ve       , Rp          , Rp          , Gs^Fds      , Gs^Fds      , Gs^Fds      , Gs^Fds      , Gs^Fds      , Gs^Fds      , Gs^Fds      , Gs^Fds      , Hh^Fp       , Hh^Fp       , Hh          , Gg^Ve       , Rp          , Gll^Fp      , Gs^Fds      , Gs^Fds      , Gs^Fds      , Gs^Fds      , Gs^Fds      , Gll^Fp      , Gll^Fp      , Gll^Fp      , Gs^Fds      , Gg          , Gg          , Gg          , Gg          , Gs^Fp       , Gs^Fds      , Rp          
Gs^Fds      , Gs^Fds      , Gs^Fds      , Gg          , Gg          , Gg          , Hh          , Hh          , Hh          , Rp          , Hh          , Gs^Fds      , Gs^Fds      , Gs^Fds      , Gs^Fds      , Gs^Fds      , Gs^Fds      , Gs^Fds      , Gs^Fds      , Gs^Fds      , Hh^Fp       , Hh^Fp       , Hh^Fp       , Hh          , Rp          , Hh          , Gs^Fds      , Gs^Fds      , Gs^Fds      , Gs^Fds      , Gs^Fds      , Gs^Fds      , Gs^Fds      , Gll^Fp      , Gs^Fds      , Gg          , Gg          , Gg          , Gs^Fp       , Gg^Ve       , Gs^Fds      , Gs^Fds      
Gs^Fds      , Gs^Fds      , Gs^Fds      , Gg          , Gg          , Gs^Fp       , Hh          , Hh          , Rp          , Rp          , Hh          , Hh          , Gs^Fds      , Gs^Fds      , Gg^Ve       , Gs^Fds      , Gs^Fds      , Gs^Fds      , Gs^Fds      , Gs^Fds      , Hh^Fp       , Hh^Fp       , Hh^Fp       , Hh^Fp       , Rp          , Hhd         , Gs^Fds      , Gs^Fds      , Gs^Fds      , Gs^Fds      , Gs^Fds      , Gs^Fds      , Gs^Fds      , Gs^Fds      , Gs^Fds      , Gg          , Gg          , Gg          , Gs^Fp       , Gs^Fp       , Gs^Fds      , Gs^Fds      
Gs^Fds      , Gg          , Rp          , Gg^Ve       , Rp          , Gs^Fp       , Rp          , Rp          , Hh          , Hh          , Hh          , Hh          , Gs^Fds      , Gs^Fds      , Gs^Fds      , Gs^Fds      , Gs^Fds      , Gs^Fds      , Gs^Fds      , Hh^Fp       , Hh^Fp       , Hh^Fp       , Hh          , Hh          , Rp          , Gs^Fds      , Hh^Fds      , Hh^Fds      , Gs^Fds      , Gs^Fds      , Gs^Fds      , Gs^Fds      , Gs^Fms      , Gs^Fds      , Gs^Fds      , Gg          , Gg          , Gg          , Gg          , Gg          , Gs^Fds      , Rp          
Gg          , Rp          , Gs^Fds      , Rp          , Gg          , Rp          , Hh          , Hh          , Hh          , Hh          , Hh          , Gs^Fds      , Gs^Fds      , Gs^Fds      , Gs^Fds      , Gs^Fds      , Gs^Fds      , Gs^Fds      , Gs^Fds      , Hh^Fp       , Hh^Fp       , Hhd         , Gs^Fds      , Gg^Fet      , Rp          , Gg^Fet      , Hh          , Hh^Fds      , Hh^Fds      , Hh^Fds      , Hh^Fds      , Gs^Fms      , Gs^Fms      , Gs^Fms      , Gs^Fds      , Gs^Fds      , Gg          , Gg          , Gg          , Gs^Fds      , Gs^Fds      , Rp          
Gs^Fp       , 3 Gs^Fds    , Gs^Fds      , Gs^Fds      , Gg          , Hh          , Hh          , Hh          , Hh          , Hh          , Hh          , Gs^Fds      , Gs^Fds      , Gs^Fds      , Gs^Fds      , Gs^Fds      , Hh^Fds      , Gs^Fds      , Hh^Fp       , Hh^Fp       , Gs^Fds      , Gs^Fds      , Gg^Efm      , Rp          , Rp          , Gs          , Gs          , Hh          , Hh          , Hh^Fds      , Hh^Fds      , Hh^Fds      , Gs^Fms      , Gs^Fms      , Gs^Fms      , Gs^Fds      , Gs^Fds      , Gs^Fds      , Gs^Fds      , Gs^Fds      , Gs^Fds      , Rp          
Gs^Fp       , Gs^Fds      , Gs^Fds      , Gs^Fds      , Hh^Fp       , Hh          , Gg^Ve       , Hh          , Hh          , Hh          , Hh          , Hh^Fds      , Hh^Fds      , Gs^Fds      , Hh^Fds      , Hh^Fds      , Hh^Fds      , Hh^Fds      , Gs^Fds      , Gs^Fds      , Gs^Fds      , Gs^Fds      , Gs^Fds      , Gg^Efm      , Rp          , Rp          , Rp          , Gs          , Gs          , Hh          , Hh          , Hh^Fds      , Mm          , 5 Gs^Fms    , Gs^Fds      , Gs^Fds      , Gs^Fds      , Gs^Fds      , Gs^Fds      , Gs^Fds      , Gs^Fds      , Rp          
Gs^Fp       , Gs^Fds      , Hh^Fp       , Hh^Fp       , Hh^Fp       , Hh^Fp       , Hh          , Hh          , Hh^Fp       , Hh          , Gs^Fds      , Hh^Fds      , Hh^Fds      , Hh^Fds      , Hh^Fds      , Hh^Fds      , Hh^Fds      , Gs^Fds      , Gg^Gvs      , Gs^Fds      , Gs^Fds      , Gs^Fds      , Rp          , Rp          , Gg          , Gg^Fet      , Gg          , Rp          , Gs          , Gs^Fms      , Hh^Fms      , Mm          , Mm          , Mm          , Gs^Fds      , Gg^Ve       , Gs^Fds      , Gs^Fds      , Gs^Fds      , Gs^Fds      , Gs^Fds      , Rp          
Hh          , Hh^Fp       , Hh          , Hh          , Hh^Fp       , Hh^Fp       , Hh          , Hh^Fp       , Hh          , Hh          , Gs^Fds      , Gs^Fds      , Gs^Fds      , Hh^Fds      , Hh^Fds      , Hh^Fds      , Hh^Fds      , Gs^Fds      , Gs^Fds      , Gs^Fds      , Gs^Fds      , Rp          , Gg^Fet      , Gg^Fet      , Gg          , Rp          , Gg^Fet      , Rp          , Gs          , Gs^Fms      , Hh^Fms      , Hh^Fms      , Mm          , Mm          , Mm          , Gs^Fds      , Gs^Fds      , Gs^Fds      , Gs^Fds      , Gs^Fds      , Gs^Fds      , Rp          
Hh          , Hh          , Hh          , Hh^Fp       , Hh          , Hh          , Hh          , Hh          , Hh          , Gs^Fds      , Gs^Fds      , Gs^Fds      , Gs^Fds      , Gs^Fds      , Gs^Fds      , Hh^Fds      , Hh^Fp       , Gs^Fds      , Gg^Gvs      , Gs^Fds      , Gg^Efm      , Rp          , Gg          , 1 Gg        , Gg^Fet      , Rp          , Gs          , Gs          , Gs^Fms      , Gs^Fms      , Gs^Fms      , Hh^Fms      , Hh^Fms      , Mm          , Mm          , Mm          , Gs^Fds      , Gs^Fds      , Gs^Fds      , Gs^Fds      , Rp          , Rp          
Hh          , Hh          , Hh          , Hh          , Gs^Fds      , Gs^Fds      , Gs^Fds      , Gs^Fds      , Gs^Fds      , Gs^Fds      , Gs^Fds      , Gs^Fds      , Gs^Fds      , Gs^Fds      , Gs^Fds      , Hh^Fp       , Hh^Fp       , Gs^Fds      , Gs^Fds      , Gs^Fds      , Gs^Fds      , Rp          , Gg^Fet      , Gg          , Rp          , Rp          , Gs          , Gs^Fms      , Gs^Fms      , Gs^Fms      , Hh^Fms      , Hh^Fms      , Mm          , Mm          , Mm          , Mm          , Gs^Fds      , Gs^Fds      , Gs^Fds      , Rp          , Gg^Ve       , Hh          
Hh          , Gg^Ve       , Hh          , Hh          , Gs^Fds      , 8 Gs^Fds    , Gs^Fds      , Hh          , Hh          , Gs^Fds      , Gs^Fds      , Gs^Fds      , Gs^Fds      , Gs^Fds      , Gs^Fds      , Gs^Fds      , Gs^Fds      , Hh^Fp       , Hh^Fp       , Gs^Fds      , Gs^Fds      , Rp          , Rp          , Rp          , Gs          , Gs          , Gs^Fms      , Gs^Fms      , Gs^Fms      , Gs^Fms      , Gs^Fms      , Hh^Fms      , Hh^Fms      , Mm          , Mm          , Mm          , Mm          , Gs^Fds      , Gll^Fp      , Rp          , Hh          , Hh          
Hh          , Gs^Fds      , Gs^Fds      , Gs^Fds      , Gs^Fds      , Gs^Fds      , Gs^Fds      , Hh          , Hh          , Hh          , Hh          , Gs^Fds      , Hh^Fp       , Hh^Fp       , Gs^Fds      , Gs^Fds      , Gs^Fds      , Gs^Fds      , Gs^Fds      , Hh^Fp       , Hh^Fp       , Gs^Fds      , Rp          , Rp          , Gg^Fet      , Gs^Fms      , Gs^Fms      , Gs^Fms      , Gs^Fms      , Gs^Fms      , Gs^Fms      , Gs^Fms      , Hh^Fms      , Hh^Fms      , Hh^Fms      , Mm          , Hh^Fms      , Gs^Fds      , Gll^Fp      , Hh          , Ha          , Hh          
Gs^Fds      , Gs^Fds      , Gs^Fds      , Gs^Fds      , Gs^Fds      , Gs^Fds      , Gs^Fds      , Gs^Fds      , Gs^Fds      , Gs^Fds      , Gs^Fds      , Hh          , Hh^Fp       , Hh^Fp       , Gs^Fds      , Gs^Fds      , Gs^Fds      , Gs^Fds      , Gs^Fds      , Gs^Fds      , Gs^Fds      , Gg^Fet      , Hhd         , Rp          , Gs^Fms      , Gs^Fms      , Gs^Fms      , Gs^Fms      , Gs^Fms      , Gs^Fms      , Gs^Fms      , Gs^Fms      , Gs^Fms      , Hh^Fms      , Hh^Fms      , Hh^Fms      , Hh^Fms      , Hh^Fms      , Rp          , Hh          , Ha          , Ha          
Gs^Fds      , Gs^Fds      , Gs^Fds      , Gs^Fds      , Gs^Fds      , Gs^Fds      , Gs^Fds      , Gs^Fds      , Gs^Fds      , Gs^Fds      , Hh^Fp       , Hh^Fp       , Hh^Fp       , Hh^Fp       , Gs^Fds      , Gs^Fds      , Gs^Fds      , Gs^Fds      , Gs^Fds      , Gs^Fds      , Gs^Fds      , Gs^Fds      , Hhd         , Rp          , Gs^Fms      , Gs^Fms      , Gs^Fms      , Gs^Fms      , Gs^Fms      , Gs^Fms      , Gs^Fms      , Gs^Fms      , Gs^Fms      , Gs^Fms      , Hh^Fms      , Hh^Fms      , Hh^Fms      , Hh^Fms      , Hh^Fp       , Hh^Fp       , Hh^Fp       , Ha          
Gs^Fds      , Gs^Fds      , Gs^Fds      , Gs^Fds      , Gs^Fds      , Gs^Fds      , Gs^Fds      , Gs^Fds      , Gs^Fds      , Gs^Fds      , Gs^Fds      , Hh^Fp       , Gs^Fds      , Gs^Fds      , Gs^Fds      , Gs^Fds      , Gs^Fds      , Gs^Fds      , Gs^Fds      , Gs^Fds      , Gs^Fds      , Gs^Fds      , Hhd         , Rp          , Gs^Fms      , Gs^Fms      , Gs^Fms      , Gs^Fms      , Gs^Fms      , Hh^Fms      , Hh^Fms      , Gs^Fms      , Gs^Fms      , Gs^Fms      , Gs^Fms      , Hh^Fms      , Gs^Fms      , Rp          , Hh^Fp       , 6 Hh^Fp     , Hh^Fp       , Ha          
Gs^Fds      , Gs^Fds      , Gs^Fds      , Gs^Fds      , Gs^Fds      , Gs^Fds      , Gs^Fds      , Gs^Fds      , Gs^Fds      , Gs^Fds      , Gs^Fds      , Gs^Fds      , Gs^Fds      , Gs^Fds      , Gs^Fds      , Gs^Fds      , Gs^Fds      , Gs^Fds      , Gs^Fds      , Gs^Fds      , Gs^Fds      , Gs^Fds      , Hhd         , Rp          , Gs^Fms      , Gs^Fms      , Gs^Fms      , Gs^Fms      , Hh^Fms      , Hh^Fms      , Hh^Fms      , Hh^Fms      , Gs^Fms      , Gs^Fms      , Gs^Fms      , Gs^Fms      , Gs^Fms      , Rp          , Gs^Fms      , Hh^Fp       , Gs^Fms      , Hh          
Gs^Fds      , Gs^Fds      , Gs^Fds      , Gs^Fds      , Gs^Fds      , Gs^Fds      , Gs^Fds      , Gs^Fds      , Gs^Fds      , Gs^Fds      , Gs^Fds      , Gs^Fds      , Gs^Fds      , Gs^Fds      , Gs^Fds      , Gs^Fds      , Ww          , Ww          , Hh^Fds      , Gs^Fds      , Gs^Fds      , Gs^Fds      , Gs^Fds      , Gll^Fp      , Gll^Fp      , Gs^Fms      , Gs^Fms      , Gs^Fms      , Gs^Fms      , Hh^Fms      , Hh^Fms      , Hh^Fms      , Hh^Fms      , Gs^Fms      , Gs^Fms      , Gs^Fms      , Gs^Fms      , Rp          , Gs^Fms      , Gs^Fms      , Gs^Fms      , Hh          
Gs^Fds      , Gs^Fds      , Gs^Fds      , Gs^Fds      , Gs^Fds      , Hh^Fp       , Hh^Fp       , Hh^Fp       , Hh^Fp       , Gs^Fds      , Gs^Fds      , Gs^Fds      , Gs^Fds      , Gs^Fds      , Gs^Fds      , Hh^Fp       , Ww          , Ww          , Hh^Fds      , Gs^Fds      , Hh^Fds      , Gs^Fds      , Hh^Fds      , Gs^Fds      , Gs^Fms      , Gll^Fp      , Gll^Fp      , Gs^Fms      , Gs^Fms      , Gs^Fms      , Gs^Fms      , Gs^Fms      , Gs^Fms      , Hh^Fms      , Hh^Fms      , Gs^Fms      , Rp          , Rp          , Gs^Fms      , Gs^Fms      , Gs^Fms      , Hh          
Gs^Fds      , Gs^Fds      , Gs^Fds      , Gs^Fds      , Gs^Fds      , Gs^Fds      , Gs^Fds      , Hh^Fp       , Hh^Fp       , Gs^Fds      , Gs^Fds      , Gs^Fds      , Gs^Fds      , Gs^Fds      , Gs^Fds      , Hh^Fp       , Ww          , Ww          , Hh^Fds      , Hh^Fds      , Hh^Fds      , Hh^Fds      , Hh^Fds      , Hh^Fds      , Hhd         , Hhd         , Hhd         , Gll^Fp      , Gll^Fp      , Gs^Fms      , Gs^Fms      , Gs^Fms      , Gs^Fms      , Gs^Fms      , Gs^Fms      , Gs^Fms      , Rp          , Gs^Fms      , Gs^Fms      , Gs^Fms      , Gs^Fms      , Gs^Fms      
Gs^Fds      , Gs^Fds      , Gs^Fds      , Gs^Fds      , Gs^Fds      , Gs^Fds      , Gs^Fds      , Gs^Fds      , Hh^Fp       , Hh^Fp       , Gs^Fds      , Gs^Fds      , Ww          , Gs^Fds      , Gs^Fds      , Hh^Fp       , Ww          , Ww          , Hh^Fds      , Hh^Fds      , Gs^Fms      , Hh^Fds      , Hh^Fds      , Hh^Fds      , Gs^Fms      , Gs^Fms      , Gs^Fms      , Gs^Fms      , Gs^Fms      , Gll^Fp      , Gll^Fp      , Gs^Fms      , Gs^Fms      , Gs^Fms      , Rp          , Rp          , Gs^Fms      , Gs^Fms      , Gs^Fms      , Gs^Fms      , Gs^Fms      , Gs^Fms      
Gs^Fds      , Gs^Fds      , Gs^Fds      , Gs^Fds      , Gs^Fds      , Gs^Fds      , Gs^Fds      , Gs^Fds      , Hh^Fp       , Hh^Fp       , Hh^Fp       , Hh^Fp       , Ww          , Ww          , Gs^Fds      , Ww          , Ww          , Ww          , Hh^Fds      , Gs^Fms      , Gs^Fms      , Gs^Fms      , Gs^Fms      , Gs^Fms      , Gs^Fms      , Gs^Fms      , Gs^Fms      , 2 Gs^Fms    , Gs^Fms      , Gs^Fms      , Hhd         , Rp          , Gs^Fms      , Gs^Fms      , Gs^Fms      , Gs^Fms      , Gs^Fms      , Gs^Fms      , Gs^Fms      , Gs^Fms      , Ww          , Ww          
Gs^Fds      , Gs^Fds      , Gs^Fds      , Gs^Fds      , Gs^Fds      , Gs^Fds      , Gs^Fds      , Gs^Fds      , Gs^Fds      , Hh^Fp       , Gg^Ve       , Ww          , Ww          , Ww          , Ww          , Ww          , Gg^Ve       , Ww          , Hh^Fds      , Gs^Fms      , Gs^Fms      , Gs^Fms      , Gs^Fms      , Gs^Fms      , Gs^Fms      , Gs^Fms      , Gs^Fms      , Gs^Fms      , Gs^Fms      , Gs^Fms      , Gs^Fms      , Rp          , Gs^Fms      , 7 Gs^Fms    , Gs^Fms      , Gs^Fms      , Gs^Fms      , Gs^Fms      , Gs^Fms      , Gs^Fms      , Ww          , Ww          
Gs^Fds      , Gs^Fds      , Gs^Fds      , Gs^Fds      , Gs^Fds      , Gs^Fds      , Gs^Fds      , Gs^Fds      , Gs^Fds      , Ww          , Ww          , Ww          , Ww          , Ww          , Ww          , Ww          , Mm          , Ww          , Ww          , Hh^Fds      , Hh^Fds      , Gs^Fms      , Gs^Fms      , Gs^Fms      , Gs^Fms      , Gs^Fms      , Gs^Fms      , Gs^Fms      , Gs^Fms      , Gs^Fms      , Rp          , Rp          , Gs^Fms      , Gs^Fms      , Gs^Fms      , Gs^Fms      , Gs^Fms      , Gs^Fms      , Gs^Fms      , Ww          , Ww          , Ww          
