border_size=1
usage=map

Hh^Fmf      , Hh^Fmf      , Hh^Fmf      , Ww          , Rr          , Ms          , Ms          , Ms          , Ms          , Ms          , Ms          , Ms          , Ms          , Ms          , Ms          , Ms          , Ms          , Ms          , Ms          , Ms          , Ms          , Ms          , Ms          , Ms          , Ms          , Ms          , Ms          , Ms          , Ms          , Ms          , Ms          , Ms          , Ms          , Ms          , Ms^Xm       , Ms^Xm       , Ms^Xm       , Ms          , Ms^Xm       , Ms          , Ms          , Ms          , Ms          , Ms          , Ms          , Ms          , Ms          , Ms          , Ms          , Ms          , Ms          , Ms          
Hh^Fmf      , Hh^Fmf      , Hh^Fmf      , Ww          , Ww          , Rr          , Ms          , Ms          , Ms          , Ms          , Ms          , Ms          , Rr          , Ms          , Ms          , Ms          , Ms          , Ms          , Ms          , Ms          , Ms          , Ms          , Ms          , Ms          , Ms          , Ms          , Ms          , Ms          , Ms          , Ms          , Ms          , Ms          , Ms          , Ms          , Ms^Xm       , Ms^Xm       , Ms^Xm       , Ms^Xm       , Ms^Xm       , Ms^Xm       , Ms          , Ms          , Ms          , Ms          , Ms          , Ms          , Ms          , Ms          , Ms          , Ms          , Ms          , Ms          
Hh^Fmf      , Hh^Fmf      , Hh^Fmf      , Hh^Fmf      , Ww          , Rr          , Aa          , Ms          , Ms          , Ms          , Rr          , Rr          , Ms          , Rr          , Ms          , Ms          , Ms          , Ms          , Ms          , Ms          , Ms          , Ms          , Ha^Fma      , Ms          , Ms          , Ms          , Ms          , Ms          , Ms          , Ms          , Ms          , Ms          , Ms          , Ms^Xm       , Ms^Xm       , Ms^Xm       , Ms^Xm       , Ms^Xm       , Ms^Xm       , Ms^Xm       , Ms          , Ms          , Ms          , Ms          , Ms          , Ms          , Ms          , Ms          , Ms          , Ms          , Ms          , Ms          
Hh^Fmf      , Hh^Fmf      , Hh^Fmf      , Hh^Fmf      , Ww          , Rr          , Ms          , Ms          , Ms          , Rr          , Ms          , Ms          , Ms          , Rr          , Ms          , Ms          , Ms          , Ms          , Ms          , Ms          , Ms          , Ha^Fma      , Ms          , Ha^Fma      , Ms          , Ms          , Ms          , Ms          , Ms          , Ms          , Ms          , Ms          , Ms          , Ms^Xm       , Ms^Xm       , Ms^Xm       , Ms^Xm       , Ms^Xm       , Ms^Xm       , Ms^Xm       , Ms^Xm       , Ms          , Ms          , Ms          , Ms          , Ms          , Ms          , Ms          , Ms          , Ms          , Ms          , Ms          
Ms          , Gg^Efm      , Gg^Efm      , Gg^Efm      , Ww          , Rr          , Ms          , Ms          , Rr          , Rr          , Ms          , Ms          , Ms          , Rr          , Ms          , Ms          , Ms          , Ms          , Ms          , Ms          , Ms          , Ms          , Ms          , Ms          , Ms          , Ms          , Ms          , Ms          , Ms          , Ms          , Ms          , Ms          , Ms          , Ms          , Ms^Xm       , Ms^Xm       , Ms^Xm       , Ms^Xm       , Ms^Xm       , Ms^Xm       , Ms^Xm       , Ms          , Ms          , Ms          , Ms          , Ms          , Ms          , Ms          , Ms          , Ms          , Ms          , Ms          
Ms          , Ms          , Ms          , Ww          , Rr          , Rr          , Ms          , Ms          , Rr          , Ha^Fpa      , Ms          , Ms          , Ms          , Rr          , Ms          , Ms          , Ms          , Ms          , Ms          , Ms          , Ms          , Ms          , Ms          , Ms          , Ms          , Ms          , Ms          , Ms          , Ms          , Ms          , Ms          , Ms          , Ms          , Ms          , Ms          , Ms^Xm       , Ms^Xm       , Ms^Xm       , Ms^Xm       , Ms^Xm       , Ms          , Ms          , Ms          , Ms          , Ms          , Ms          , Ms          , Ms          , Ms          , Ms          , Ms          , Ms          
Ms          , Ms          , Ms          , Ww          , Rr          , Ms          , Rr          , Rr          , Chr         , Chr         , Ms          , Ms          , Ms          , Rr          , Aa          , Ms          , Ms          , Ms          , Aa          , Ms          , Ms          , Ms          , Ha          , Ms          , Ms          , Ms          , Ms          , Ms          , Ms          , Ms          , Ms          , Ms          , Ms          , Ms          , Ms          , Ms^Xm       , Ms^Xm       , Ms^Xm       , Ms          , Ms          , Ms          , Ms          , Ms          , Ms          , Ms          , Ms          , Ms          , Ms          , Ms          , Ms          , Ms          , Ms          
Ms          , Ms          , Ms          , Ww          , Ww          , Rr          , Ms          , Khr         , Ms          , Ms          , Ms          , Ms          , Ms          , Rr          , Aa          , Aa          , Aa          , Ha          , Aa          , Ha          , Rr          , Ha          , 2 Rr        , Ms^Vhha     , Ms^Vhha     , Ms          , Ms          , Ms          , Ms          , Ms          , Ms          , Ms          , Ms          , Ms          , Ms          , Ms          , Ms          , Ms          , Ms          , Ms          , Ms          , Ms          , Ms          , Ms          , Ms          , Ms          , Ms          , Ms          , Ms          , Ms          , Ms          , Ms          
Ms          , Ms          , Ms          , Ms          , Ms          , Ww          , Ms          , Chr         , Ms          , Ms          , Ms          , Ms          , Ms          , Rr          , Rr          , Rr          , Rr          , Rr          , Rr          , Rr          , Aa          , Rr          , Aa          , Rr          , Rr          , Ha^Vhha     , Ha          , Ms          , Ms          , Ms          , Ms          , Ms          , Ms          , Ms          , Ms          , Ms          , Ms          , Ms          , Ms          , Ms          , Ms          , Ms          , Ms          , Ms          , Ms          , Ai          , Ww          , Ms          , Ms          , Ms          , Ms          , Ms          
Ms          , Ms          , Ms          , Ms          , Ms          , Ms          , Ms          , Ha          , Ms          , Ha          , Ms          , Ms          , Ha          , Ha^Fpa      , Ha^Fpa      , Ha^Fpa      , Ms          , Ha          , Ms          , Aa          , Aa          , Aa          , Aa          , Ha          , Ha          , Rr          , Ha          , Ha          , Ms          , Ms          , Ms          , Ms          , Ms          , Ms          , Ms          , Ms          , Ms          , Ms          , Ms          , Ms          , Ms          , Ms          , Ms          , Ms          , Ww          , Ww          , Ww          , Ai          , Ai          , Ms          , Ms          , Ms          
Ms          , Ms          , Ms          , Ms          , Ms          , Ms          , Ms          , Ms          , Ms          , Ms          , Ms          , Ms          , Ms          , Ms          , Ms          , Ms          , Ms          , Ms          , Ms          , Ms          , Ms          , Aa          , Ha          , Aa          , Aa          , Rr          , Aa          , Aa          , Ha          , Ms          , Ms          , Ms          , Ms          , Ms          , Ms          , Ms          , Ms          , Ms          , Ms          , Ms          , Ms          , Ms          , Ms          , Ms          , Ms          , Ms          , Ms          , Ww          , Ww          , Ai          , Ms          , Ms          
Ms          , Ms          , Ms          , Ms          , Ms          , Ms          , Ms          , Ms          , Ms          , Ms          , Ms          , Ms          , Ms          , Ms          , Ms          , Ms          , Ms          , Ms          , Ms          , Ms          , Ms          , Ms          , Ms          , Ha          , Ha          , Rr          , Rr          , Ha          , Aa          , Ha          , Ms          , Ms          , Ms          , Ms          , Ms          , Ms          , Ms          , Ms          , Ms          , Ms          , Ms          , Ms          , Ms          , Ms          , Ms          , Ms          , Ai          , Ww          , Ww          , Ww          , Aa          , Ms          
Ms          , Ms          , Ms          , Ms          , Ms          , Ms          , Ms          , Ms          , Ms          , Ms          , Ms          , Ms          , Ms          , Ms          , Ms          , Ms          , Ms          , Ms          , Ms          , Ms          , Cud         , Ms          , Ms          , Ms          , Ms          , Ha          , Rr          , Ha          , Ha          , Aa          , Ms          , Ms          , Ms          , Ms          , Ms          , Ms          , Ms          , Ms          , Ms          , Ms          , Ms          , Ms          , Ms          , Ms          , Ms          , Ms          , Ww          , Ww          , Ai          , Ww          , Aa          , Ha^Fpa      
Ms          , Ms          , Ms          , Ms          , Ms          , Ms          , Ms          , Ms          , Ms          , Ms          , Ms          , Ms          , Ms          , Ms          , Ms          , Ms          , Ms          , Ms          , Kh          , Cud         , Cud         , Cud         , Ha^Vhha     , Cud         , Ms          , Ha          , Ha          , Rr          , Rr          , Ha          , Ha          , Ms          , Ms          , Ms          , Ms          , Ms          , Ms          , Ms          , Ms          , Ms          , Ms          , Ms          , Ms          , Ms          , Ww          , Ww          , Ms          , Ms          , Ha^Fpa      , Aa          , Ha^Fpa      , Ha^Fpa      
Ms          , Ms          , Ms          , Ms          , Ms          , Ms          , Ms          , Ms          , Ms          , Ms          , Ms          , Ms          , Ms          , Ms          , Ms          , Ms          , Ms          , Cud         , Ha^Vhha     , Kh          , Khr         , Cud         , Cud         , Cud         , Ms          , Ms          , Ha          , Aa          , Rr          , Ha          , Ha          , Ms          , Ms          , Ms          , Ms          , Chr         , Ms          , Ms          , Rr          , Rr          , Rr          , Ms          , Ms          , Ms          , Ww          , Ms          , Rr          , Ms          , 3 Ha^Fpa    , Ha^Fpa      , Ha^Fpa      , Ha^Fpa      
Ms          , Ms          , Ms          , Ms          , Ms          , Ms          , Ms          , Ms          , Ms          , Ms          , Ms          , Ms          , Ms          , Ms          , Ms          , Ms          , Ms          , Cud         , Cud         , Ha^Vhha     , Cud         , Cud         , Ms          , Ms          , Ms          , Ms          , Ha          , Aa          , Aa          , Rr          , Rr          , Ha          , Ms          , Ms          , Khr         , Chr         , Ha^Fpa      , Rr          , Ms          , Ms          , Rr          , Ms          , Ms          , Ms          , Ww^Bw/      , Rr          , Ms          , Ha^Fpa      , Ha^Fpa      , Ha^Fpa      , Ha^Fpa      , Ha^Fpa      
Ms          , Ms          , Ms          , Ms          , Ms          , Ms          , Ms          , Ms          , Ms          , Ms          , Ms          , Ms          , Ms          , Ms          , Ms          , Ms          , Ms          , Ms          , Ha^Fpa      , Ha^Fpa      , Ms          , Ms          , Ms          , Ms          , Ms          , Ms          , Ms          , Ha          , Aa          , Aa          , Rr          , Ha          , Ha          , Ms          , Ms          , Ms          , Rr          , Rr          , Ms          , Ms^Xm       , Rr          , Ha^Fpa      , Rr          , Rr          , Ww          , Ms          , Ms          , Ms          , Ms          , Ha^Fpa      , Ha^Fpa      , Ha^Fpa      
Ms          , Ms          , Ms          , Ms          , Ms          , Ms          , Ms          , Ms          , Ms          , Ms          , Ms          , Ms          , Ms          , Ms          , Ms          , Ms          , Ms          , Ms          , Ha^Fpa      , Ha^Fpa      , Ms          , Ms          , Ms          , Ms          , Ms          , Ms          , Ha^Fpa      , Ha          , Ha          , Aa          , Rr          , Ha          , Rr          , Ha^Fma      , Ha^Fma      , Ms          , Rr          , Ms          , Ms^Xm       , Ms^Xm       , Rr          , Rr          , Ms          , Ms          , Ww          , Ms          , Ms          , Ms          , Ms^Xm       , Ms          , Ms          , Ms          
Ms          , Ms          , Ms          , Ms          , Ms          , Ms          , Ms          , Ms          , Ms          , Ms          , Ms          , Ms          , Ms          , Ms          , Ms          , Ms          , Ms          , Ms          , Ha^Fma      , Ha^Fpa      , Ha^Fma      , Ms          , Ms          , Ms          , Ha^Fma      , Ha^Fma      , Ha^Fma      , Ha^Fma      , Ha^Fpa      , Ha^Fpa      , Ha^Fpa      , Rr          , Ha^Fpa      , Rr          , Rr          , Rr          , Ha^Fma      , Ms^Xm       , Ms^Xm       , Ms          , Rr          , Ms          , Ms          , Ms          , Rr          , Ww          , Ww          , Ms          , Ms^Xm       , Ms^Xm       , Ms^Xm       , Ms^Xm       
Ms          , Ms          , Ms          , Ms          , Ms          , Ms          , Ms          , Ms          , Ms          , Ms          , Ms          , Ms          , Ms          , Ms          , Ms          , Ms          , Ms          , Ms          , Ms          , Ha^Fma      , Ha^Fpa      , Ha^Fma      , Ha^Fpa      , Ha^Fpa      , Ha^Fma      , Ha^Fpa      , Ha^Fma      , Ha^Fma      , Ha^Fma      , Ha^Fpa      , Ha^Fpa      , Ha^Fpa      , Ha^Fpa      , Ha^Fma      , Ha^Fma      , Ha^Fma      , Ha^Fma      , Ms          , Ms^Xm       , Ms^Xm       , Ms^Xm       , Rr          , Rr          , Rr          , Ms          , Rr          , Ww          , Ms          , Ms^Xm       , Ms^Xm       , Ms^Xm       , Ms^Xm       
Ms          , Ms          , Ms          , Ms          , Ms          , Ms          , Ms          , Ms          , Ms          , Ms          , Ms          , Ms          , Ms          , Ms          , Ms          , Ms          , Ms          , Ms          , Ms          , Ha^Fpa      , Ha^Fpa      , Ha^Fma      , Ms          , Ha^Fma      , Ms          , Ms          , Ms          , Ms          , Ms          , Ms          , Ms          , Ha^Fpa      , Ha^Fma      , Ha^Fpa      , Ha^Fpa      , Ha^Fma      , Ha^Fma      , Ms          , Ms          , Ms^Xm       , Ms^Xm       , Ms^Xm       , Ms          , Ms          , Ms          , Rr          , Ww          , Ms          , Ms^Xm       , Ms^Xm       , Ms^Xm       , Ms^Xm       
Ms          , Ms          , Ms          , Ms          , Ms          , Ms          , Ms          , Ms          , Ms          , Ms          , Ms          , Ms          , Ms          , Ms          , Ms          , Ms          , Ms          , Ha          , Ms          , Ha^Fpa      , Ha          , Ms          , Ms          , Ms          , Ms          , Ms          , Ms          , Ms          , Ms          , Ms          , Ms          , Ms          , Ha^Fma      , Ha^Fpa      , Ha^Fpa      , Ha^Fma      , Ms          , Ms          , Ms          , Ms^Xm       , Ms^Xm       , Ms          , Ms          , Ms          , Rr          , Rr          , Ww          , Ms          , Ms          , Ms^Xm       , Ms^Xm       , Ms^Xm       
Ms          , Ms          , Ms          , Ms          , Ms          , Ms          , Ms          , Ms          , Ms          , Ms          , Ms          , Ms          , Ms          , Ms          , Ms          , Ms          , Ms          , Ms          , Ms          , Ha          , Ms          , Ms          , Ms          , Ha          , Ms          , Ha          , Ms          , Ms          , Ms          , Ms          , Ms          , Ms          , Ha^Fma      , Ha^Fma      , Ha^Fma      , Ms          , Ms          , Ms          , Ms          , Ms^Xm       , Ms          , Ms          , Rr          , Rr          , Ms          , Ms          , Ms          , Ww          , Ww          , Ms          , Ms          , Ms^Xm       
Ms          , Ms          , Ms          , Ms          , Ms          , Ms          , Ms          , Ms          , Ms          , Ms          , Ms          , Ms          , Ms          , Ms          , Ms          , Ms          , Ms          , Ms          , Ms          , Ms          , Ms          , Ms          , Ms          , Ms          , Ms          , Ms          , Ms          , Ms          , Ms          , Ms          , Ms^Xm       , Ms^Xm       , Ms^Xm       , Ha^Fma      , Ha^Fma      , Ms          , Chr         , Khr         , Ms          , Ms          , Rr          , Rr          , Ha^Fma      , Ha          , Hh^Fmf      , Ms          , Ms          , Ms          , Ww          , Ms          , Ms          , Ms^Xm       
Ms          , Ms          , Ms          , Ms          , Ms          , Ms          , Ms          , Ms          , Ms          , Ms          , Ms          , Ms          , Ms          , Ms          , Ms          , Ms          , Ms          , Ms          , Ms          , Ms          , Ms          , Ms          , Ms          , Ms          , Ms          , Ms          , Ms^Xm       , Ms          , Ms^Xm       , Ms^Xm       , Ms^Xm       , Ms^Xm       , Ms^Xm       , Ms          , Ww          , Chr         , Ms          , Ms          , Rr          , Rr          , Ha^Fma      , Aa          , Ha^Fma      , Ha^Fma      , Aa^Fpa      , Hh^Fmf      , Hh^Fmf      , Aa          , Ww          , Ms          , Ms          , Ms          
Ms          , Ms          , Ms          , Ms          , Ms          , Ms          , Ms          , Ms          , Ms          , Ms          , Ms          , Ms          , Ms          , Ms          , Ms          , Ms          , Ms          , Ms          , Ms          , Ms          , Ms          , Ms          , Ms          , Ms          , Ms          , Ms^Xm       , Ms^Xm       , Ms^Xm       , Ms^Xm       , Ms^Xm       , Ms^Xm       , Ms^Xm       , Ms^Xm       , Ms          , Ms          , Ww          , Ww          , Ms          , Rr          , Ha^Fma      , Ha^Fma      , Ha^Fma      , Hh^Fmf      , Aa^Fpa      , Hh^Fmf      , Aa^Fpa      , Hh^Fdf      , Hh^Fmf      , Ww          , Hh^Fmf      , Ms          , Ms          
Ms          , Ms          , Ms          , Ms          , Ms          , Ms          , Ms          , Ms          , Ms          , Ms          , Ms          , Ms          , Ms          , Ms          , Ms          , Ms          , Ms          , Ms          , Ms          , Ms          , Ms          , Ms          , Ms          , Ms          , Ms          , Ms          , Ms          , Ms^Xm       , Ms^Xm       , Ms^Xm       , Ms^Xm       , Ms^Xm       , Ms^Xm       , Ms          , Ms          , Ms          , Ha^Fma      , Ww          , Rr          , Ha^Fma      , Hh^Fmf      , Hh^Fmf      , Hh^Fmf      , Aa^Fpa      , Gs^Fmf      , Hh^Fdf      , Aa          , Aa          , Ww          , Hh^Fmf      , Aa          , Ms          
Ms          , Ms          , Ms          , Ms          , Ms          , Ms          , Ms          , Ms          , Ms          , Ms          , Ms          , Ms          , Ms          , Ms          , Ms          , Ms          , Ms          , Ms          , Ms          , Ms          , Ms          , Ms          , Ms          , Ms          , Ms          , Ms          , Ms          , Ms^Xm       , Ms^Xm       , Ms^Xm       , Ms^Xm       , Ms^Xm       , Ms^Xm       , Ms^Xm       , Ms^Xm       , Ms          , Ha^Fma      , Ww          , Ha^Fma      , Rr          , Rr          , Hh^Fmf      , Rr          , Hh^Fmf      , Hh^Fdf      , Hh^Fdf      , Hh^Fdf      , Gs^Fmf      , Ww          , Hh^Fmf      , Hh^Fmf      , Gg^Efm      
Ms          , Ms          , Ms          , Ms          , Ms          , Ms          , Ms          , Ms          , Ms          , Ms          , Ms          , Ms          , Ms          , Ms          , Ms          , Ms          , Ms          , Ms          , Ms          , Ms          , Ms          , Ms          , Ms          , Ms          , Ms          , Ms          , Ms          , Ms          , Ms^Xm       , Ms^Xm       , Ms^Xm       , Ms^Xm       , Ms^Xm       , Ms^Xm       , Ms^Xm       , Ms          , Ms          , Ww          , Ww          , Ww          , Ww          , Rr          , Aa          , Rr          , Rr          , Hh^Fmf      , Hh^Fmf      , Hh^Fmf      , Ww          , Hh^Fmf      , Gg^Efm      , Gg^Efm      
Ms          , Ms          , Ms          , Ms          , Ms          , Ms          , Ms          , Ms          , Ms          , Ms          , Ms          , Ms          , Ms          , Ms          , Ms          , Ms          , Ms          , Ms          , Ms          , Ms          , Ms          , Ms          , Ms          , Ms          , Ms          , Ms          , Ms          , Ms          , Ms^Xm       , Ms^Xm       , Ms^Xm       , Ms^Xm       , Ms^Xm       , Ms^Xm       , Ms^Xm       , Ms          , Ms          , Ms          , Hh^Fmf      , Hh^Fmf      , Ww          , Hh^Fmf      , Hh^Fdf      , Hh^Fmf      , Hh^Fmf      , Rr          , 1 Rr        , Rr          , Ww^Bw\      , Gg^Efm      , Gg^Efm      , Gg^Efm      
Ms          , Ms          , Ms          , Ms          , Ms          , Ms          , Ms          , Ms          , Ms          , Ms          , Ms          , Ms          , Ms          , Ms          , Ms          , Ms          , Ms          , Ms          , Ms          , Ms          , Ms          , Ms          , Ms          , Ms          , Ms          , Ms          , Ms          , Ms          , Ms^Xm       , Ms^Xm       , Ms^Xm       , Ms^Xm       , Ms^Xm       , Ms^Xm       , Ms^Xm       , Ms          , Ms          , Ms          , Hh^Fmf      , Aa          , Ww          , Hh^Fdf      , Ww          , Hh^Fmf      , Hh^Fmf      , Gg^Efm      , Aa          , Aa          , Ww          , Rr          , Rr          , Gg^Efm      
Ms          , Ms          , Ms          , Ms          , Ms          , Ms          , Ms          , Ms          , Ms          , Ms          , Ms          , Ms          , Ms          , Ms          , Ms          , Ms          , Ms          , Ms          , Ms          , Ms          , Ms          , Ms          , Ms          , Ms          , Ms          , Ms          , Ms          , Ms          , Ms^Xm       , Ms^Xm       , Ms^Xm       , Ms^Xm       , Ms^Xm       , Ms^Xm       , Ms^Xm       , Ms          , Ms          , Ms          , Ms          , Hh^Fmf      , Hh^Fmf      , Ww          , Hh^Fmf      , Ww          , Ww          , Aa          , Gg^Efm      , Aa          , Ww          , Gg^Efm      , Gg^Efm      , Rr          
