border_size=1
usage=map

Gg          , Gg          , Gg          , Gg          , Gg          , Gg          , Gg          , Gg          , Rr          , Rr          , Gg          , Rr          , Rr          , Gg          , Gg          , Gg          , Rr          , Rr          , Rr          , Gg          , Gg          , Gg          , Gg          , Gg          , Gg          , Gs^Fp       , Gs^Fp       , Gs^Fp       , Ds          , Wo          , Gs^Fp       , Gs^Fp       , Gs^Fp       , Gs^Fp       , Hh          , Hh          , Gg          , Gg          , Gg          , Gs^Fp       , Gs^Fp       , Gs^Fp       , Gs^Fp       , Gs^Fp       , Gs^Fp       , Ss          , Ss          , Ss          , Ss          , Gs^Fp       , Gs^Fp       , Gs^Fp       
Gg          , Gg          , Gg          , Gg          , Gg          , Gg          , Gg          , Rr          , Gg          , Gg          , Gg^Vh       , Gg          , Gg          , Rr          , Rr          , Rr          , Gg          , Hh          , Gg          , Rr          , Rr          , Gg          , Hh          , Hh          , Gg          , Gg          , Gs^Fp       , Gs^Fp       , Wo          , Wo          , Rr          , Gs^Fp       , Gs^Fp       , Gs^Fp       , Gg          , Gg          , Gg          , Gg          , Gg          , Gg          , Gg          , Gg          , Gs^Fp       , Gs^Fp       , Ss          , Ss          , Co          , Co          , Co          , Ss          , Co          , Gs^Fp       
Gg          , Rr          , Gg          , Gg          , Gg          , Gg          , Gg          , Gg          , Gg          , Gg          , Rr          , Rr          , Rr          , Gg          , Gg          , Gg          , Hh          , Gg          , Gg          , Gg          , Gg          , Gg          , Rr          , Gg          , Rr          , Rr          , Rr          , Rr          , Wo          , Wo          , Gg^Ve       , Rr          , Gs^Fp       , Gg          , Gg          , Gg          , Gg^Vh       , Gg          , Gg          , Gg          , Gg          , Gg          , Gs^Fp       , Gs^Fp       , Ss          , Ss          , 4 Ko        , Co          , Co          , Co          , Gg          , Gs^Fp       
Gg          , Rr          , Rr          , Gg          , Gg          , Gg          , Gg          , Gg          , Rr          , Rr          , Ds          , Ds          , Gg          , Rr          , Gg          , Hh          , Hh          , Gg          , Gg          , Gg          , Gg          , Rr          , Gg^Vh       , Rr          , Gg          , Gg          , Ds          , Wo          , Wo          , Gg          , Gs^Fp       , Rr          , Rr          , Rr          , Rr          , Rr          , Rr          , Gg          , Gg          , Ds          , Gg          , Gg          , Gs^Fp       , Gs^Fp       , Ss          , Gg          , Ds          , Ds          , Gg          , Gg          , Gs^Fp       , Gs^Fp       
Gg          , Gg          , Gg          , Gg          , Rr          , Rr          , Ds          , Ds          , Ds          , Ds          , Gg          , Ds          , Gs^Fp       , Rr          , Gg          , Gg          , Hh          , Gs^Vh       , Hh          , Gg          , Gg          , Gg          , Gg          , Gg          , Gg          , Gg          , Ds          , Wo          , Wo          , Gg          , Gs^Fp       , Gg          , Gg          , Gg          , Gg          , Gg          , Gg          , Rr          , Ds          , Gg          , Gg          , Gg          , Gg          , Gg          , Ss          , Ss          , Gg          , Ss          , Ss          , Gg          , Gs^Fp       , Hh          
Gg          , Gg          , Rr          , Rr          , Gg          , Ds          , Gg          , Gg          , Gg          , Gg          , Gg          , Ds          , Gs^Fp       , Rr          , Rr          , Gg          , Hh          , Gg          , Hh          , Hh          , Gg          , Gs^Fp       , Gs^Fp       , Gs^Fp       , Gs^Fp       , Gg          , Ds          , Wo          , Wo          , Gs^Fp       , Gg          , Gg          , Gg          , Gg          , Gg          , Gg          , Gg          , Rr          , Rr          , Gg          , Gg^Vh       , Gg          , Gg          , Gg          , Gs^Fp       , Gs^Fp       , Ss          , Ss          , Gs^Fp       , Gg          , Hh          , Mm          
Gg          , Rr          , Gg          , Gg          , Gg          , Ds          , Gg          , Gg          , Gg          , Gg          , Ce          , Ds          , Gg          , Gs^Fp       , Rr          , Gg          , Hh          , Hh          , Hh          , Gg          , Gg          , Gs^Fp       , Gs^Fp       , Gs^Fp       , Gs^Fp       , Ds          , Ds          , Wo          , Wo          , Gg          , Gg          , Gg          , Gg          , Gg          , Gg          , Gg          , Gg          , Gg^Vh       , Gg          , Rr          , Rr          , Rr          , Rr          , Gg          , Gg^Vh       , Ch          , Ch          , Ch          , Gs^Fp       , Hh          , Mm          , Mm          
Rr          , Gg          , Gg          , Gg          , Gs^Fp       , Ds          , Gg          , Gg          , Ce          , Ce          , 1 Ke        , Ce          , Gg          , Gg          , Gg          , Rr          , Rr          , Gg          , Gg          , Gg          , Gs^Fp       , Gs^Fp       , Gs^Fp       , Gs^Fp       , Ds          , Ds          , Wo          , Wo          , Wo          , Gg          , Gg          , Gg          , Gg          , Gg          , Gg          , Gg          , Gg          , Gg          , Gg          , Gg          , Gg          , Gg          , Gs^Fp       , Rr          , Rr          , Ch          , 2 Kh        , Ch          , Gs^Fp       , Hh          , Mm          , Ww          
Rr          , Gg          , Gg          , Gg          , Gs^Fp       , Ds          , Gg          , Gg          , Gg          , Gg          , Ce          , Ce          , Ce          , Gg          , Gg          , Gg          , Gg          , Rr          , Rr          , Gg          , Gs^Fp       , Ss          , Ds          , Ds          , Ds          , Wo          , Wo          , Wo          , Wo          , Wo          , Gg          , Gg          , Gg          , Gg          , Gg          , Ds          , Ds          , Gg          , Gg          , Gg          , Gg          , Gg          , Gg          , Gg          , Ch          , Ch          , Ch          , Gg          , Gg          , Hh          , Mm          , Ww          
Gg          , Gg          , Gg          , Gg          , Gs^Fp       , Ds          , Gg          , Gg          , Gg          , Gg          , Gg          , Ce          , Gg          , Gg          , Gg          , Gs^Fp       , Gg^Ve       , Gs^Fp       , Gg          , Rr          , Rr          , Ds          , Wo          , Wo          , Wo          , Wo          , Wo          , Wo          , Wo          , Wo          , Wo          , Wo          , Wo          , Wo          , Wo          , Wo          , Ds          , Gg          , Gg          , Gg          , Gg          , Gg          , Gg          , Gg          , Gg          , Gg          , Gg          , Gg          , Gg          , Hh          , Hh          , Mm          
Gg          , Ds          , Ds          , Ds          , Ds          , Gg          , Gg          , Gg          , Gg          , Gg          , Gg          , Gg          , Gg^Ve       , Gs^Fp       , Gs^Fp       , Gs^Fp       , Gs^Fp       , Gs^Fp       , Gg          , Gg          , Gg          , Rr          , Rr          , Ds          , Ds          , Ds          , Ds          , Wo          , Wo          , Wo          , Wo          , Wo          , Wo          , Wo          , Wo          , Wo          , Wo          , Gg          , Gg          , Gg          , Gg          , Gg          , Gg          , Gg          , Gg          , Gg          , Gg^Vh       , Gg          , Gg          , Hh          , Hh          , Hh          
Gg          , Gg          , Gg          , Gg          , Gg          , Gg          , Gg          , Gg          , Gg          , Gs^Vh       , Ds          , Gg          , Gs^Fp       , Gs^Fp       , Gs^Fp       , Gs^Fp       , Gs^Fp       , Gs^Fp       , Gg          , Gg          , Gg          , Gg          , Gg          , Rr          , Gg^Ve       , Gs^Fp       , Gs^Fp       , Ds          , Wo          , Wo          , Wo          , Gs^Vh       , Gs^Vh       , Ch          , Wo          , Wo          , Gg          , Gg          , Gg          , Gg          , Gg          , Gg          , Gg          , Gg          , Gg          , Gg          , Gg          , Gg          , Gg          , Gg          , Hh          , Hh          
Gg          , Gg          , Gg          , Gg          , Gg          , Gg          , Gg          , Gg          , Gg          , Gg          , Ds          , Gg          , Gs^Fp       , Gs^Fp       , Gs^Fp       , Gg          , Gg          , Gg          , Gg          , Gg          , Gg          , Gg          , Gg          , Rr          , Gs^Fp       , Gs^Fp       , Gs^Fp       , Gg^Ve       , Wo          , Wo          , Rrc         , Kh          , 6 Kh        , Ch          , Ch          , Gs^Vh       , Gg          , Gg          , Gg          , Gg          , Gg          , Gg          , Gg          , Gg          , Gg          , Gg          , Gg          , Gg          , Gg          , Gg          , Hh          , Gg          
Gg          , Gg          , Gg          , Gg          , Gg          , Gg          , Gg          , Gg          , Ds          , Gg          , Ds          , Gs^Fp       , Gs^Fp       , Gs^Fp       , Gs^Fp       , Gg          , Gg^Vh       , Gg          , Gg          , Gg          , Gg          , Gg          , Gs^Vh       , Rr          , Rrc         , Gs^Fp       , Rrc         , Gs^Fp       , Rrc         , Rrc         , Rrc         , Rrc         , Ch          , Gg          , Ch          , Gg^Vh       , Gg          , Gg          , Gg          , Gg          , Gg          , Gg          , Gg          , Gg          , Gg          , Gg          , Gg          , Gg          , Gg          , Gg          , Gg          , Gg          
Ds          , Ds          , Ds          , Ds          , Gg          , Gg          , Gg          , Gg          , Gg          , Gg          , Ds          , Gg          , Gs^Fp       , Gs^Fp       , Gg          , Gg          , Gg          , Gg          , Gg          , Gg          , Gg          , Gg          , Gg          , Gg          , Rr          , Rrc         , Kh          , Rrc         , Rrc         , Rrc         , Rr^Vhc      , Rr^Vhc      , Wo          , Ch          , Gs^Vh       , Gs^Vh       , Gg          , Gg          , Gg          , Gg          , Gg          , Ds          , Wo          , Gg          , Gg^Vh       , Gg          , Gg          , Gg          , Gg          , Gg          , Gg          , Gg          
Gs^Fp       , Gs^Fp       , Gg          , Gs^Fp       , Ds          , Gg          , Gg          , Gg          , Gg          , Gg          , Ds          , Gg          , Gg^Ve       , Gs^Fp       , Gg          , Gg          , Gg          , Gg          , Gg          , Gg          , Gg          , Gg          , Gs^Vh       , Gg          , Rr          , Ch          , Ch          , Ch          , Ch          , Ch          , Wo          , Wo          , Wo          , Wo          , Gg          , Gg          , Gg          , Gg          , Gg          , Gg          , Gg          , Gg          , Ds          , Gg          , Gg          , Gg          , Gg          , Gg          , Ds          , Ds          , Ds          , Gg          
Gg          , Gg          , Gs^Fp       , Gs^Fp       , Gg          , Ds          , Ds          , Ds          , Gg          , Gg          , Gg          , Ds          , Gs^Fp       , Ss          , Ss          , Gs^Fp       , Gs^Fp       , Gs^Fp       , Ds          , Ds          , Gg          , Gg          , Gg          , Gg          , Gg          , Rr          , Rr          , Ch          , Ss          , Ch          , Wo          , Wo          , Wo          , Wo          , Gg          , Gg          , Gg          , Gg          , Gg          , Gg          , Gs^Fp       , Gs^Fp       , Ds          , Gs^Fp       , Gs^Fp       , Gg          , Ds          , Ds          , Gg          , Gg          , Gg          , Gg          
Rr          , Gs^Fp       , Gg          , Gg          , Gg          , Gs^Fp       , Gs^Fp       , Gs^Fp       , Ds          , Gg          , Gg          , Gg          , Ds          , Gs^Vh       , Ds          , Gs^Vh       , Ds          , Gg          , Gg          , Gg          , Gg          , Ds          , Gg          , Gs^Vh       , Gs^Fp       , Gg          , Gg          , Rr          , Rr          , Ss          , Ss          , Wo          , Wo          , Wo          , Ds          , Gg          , Gg          , Gg          , Gg          , Gs^Fp       , Gs^Fp       , Ss          , Ss          , Ss          , Ds          , Ds          , Gg          , Ds          , Ds          , Ds          , Ds          , Ds          
Gg          , Rr          , Rr          , Gs^Fp       , Gs^Fp       , Gs^Fp       , Gs^Fp       , Gs^Fp       , Ds          , Gg          , Gg          , Gg          , Gg          , Gg          , Gg          , Gg          , Gg          , Gg          , Gg          , Gg          , Gg          , Ds          , Gs^Fp       , Gs^Fp       , Gs^Fp       , Gg          , Gg          , Gs^Vh       , Rr          , Gg          , Gg          , Ss          , Ds          , Wo          , Wo          , Gg          , Gg          , Gg          , Gg          , Gs^Fp       , Gg^Ve       , Gg          , Ss          , Ds          , Gg          , Gg          , Ds          , Gg          , Gg          , Gg          , Gg          , Gs^Fp       
Gg          , Gs^Fp       , Gs^Fp       , Rr          , Gs^Fp       , Gs^Fp       , Gs^Fp       , Gs^Fp       , Ds          , Gg          , Gg          , Gg          , Gg          , Gg          , Gg          , Gg          , Gg          , Gg          , Gg          , Gg          , Ds          , Ds          , Ss          , Gg^Ve       , Gs^Fp       , Gg          , Gg          , Gg          , Gs^Fp       , Rr          , Rr          , Gg          , Ds          , Wo          , Wo          , Gg          , Gg^Vh       , Gg          , Gg          , Gg          , Gs^Fp       , Gg          , Ss          , Ds          , Gg          , Ds          , Gg          , Gg          , Gg          , Gg          , Gs^Fp       , Gs^Fp       
Gs^Fp       , Gs^Fp       , Gg          , Rr          , Rr          , Gs^Fp       , Gs^Fp       , Gs^Fp       , Ds          , Gg          , Gg          , Gg          , Gg          , Gg          , Gg          , Gg          , Gg          , Gg          , Gg          , Gg          , Ds          , Ss          , Gs^Fp       , Gs^Fp       , Gs^Fp       , Gs^Fp       , Gg          , Gg          , Gs^Fp       , Gg^Vh       , Rr          , Gg          , Ds          , Wo          , Wo          , Gg          , Gg          , Gg          , Gg          , Gg          , Gg          , Ss          , Ds          , Ds          , Gg          , Ds          , Gg          , Gg^Vh       , Gg          , Gg          , Gg          , Gs^Fp       
Gs^Fp       , Hh          , Hh          , Hh^Fp       , Hh^Fp       , Hh^Fp       , Gs^Fp       , Gs^Fp       , Gs^Fp       , Ds          , Ds          , Ds          , Gg          , Gg          , Gg          , Gg          , Chr         , Gg          , Chr         , Gg          , Ss          , Ss          , Gs^Fp       , Gs^Fp       , Gs^Fp       , Gg          , Hh          , Hh          , Hh          , Gs^Fp       , Rr          , Ss          , Ds          , Wo          , Wo          , Gg          , Gg          , Gg          , Gg          , Gg          , Gg          , Ds          , Gg          , Gg          , Gg          , Ds          , Gg          , Gg          , Gg          , Gg          , Gg          , Gg          
Hh          , Hh          , Hh          , Hh^Fp       , Hh^Fp       , Hh^Fp       , Gs^Fp       , Gg          , Gs^Fp       , Gg          , Gs^Fp       , Ds          , Ds          , Gg          , Gg          , Gg          , 3 Khr       , Ce          , Ce          , Gg          , Ss          , Gs^Fp       , Gg          , Gg          , Hh          , Hh          , Mm          , Mm          , Hh          , Gs^Fp       , Rr          , Gs^Fp       , Ds          , Wo          , Wo          , Gs^Fp       , Gg          , Gs^Fp       , Gg          , Gg          , Gg          , Ds          , Gg          , Gg          , Gg          , Ds          , Gs^Fp       , Gg          , Gg          , Gg          , Gg^Vh       , Gg          
Hh          , Hh          , Hh^Fp       , Hh^Fp       , Hh^Fp       , Gg          , Gs^Fp       , Gs^Fp       , Ss          , Ss          , Ss          , Ss          , Ds          , Ds          , Gg          , Gg          , Chr         , Ce          , Ce          , Gg          , Gs^Fp       , Gg          , Gg          , Hh          , Hh          , Hh          , Mm          , Mm          , Hh          , Gg          , Rr          , Ds          , Wo          , Wo          , Ds          , Ds          , Gg          , Gg          , Gg          , Gg          , Gg          , Gg          , Gg          , Gg          , Gg          , Ds          , Ss          , Gs^Fp       , Gg          , Gg          , Gg          , Hh          
Hh          , Hh          , Hh          , Hh          , Gg          , Gg          , Gs^Fp       , Gs^Fp       , Gs^Fp       , Gg          , Gg          , Ss          , Ss          , Ds          , Gg          , Gg          , Gg          , Chr         , Gg          , Gg          , Gg          , Gg^Vh       , Gg          , Hh          , Hh          , Hh          , Mm          , Mm          , Hh          , Gg^Vh       , Rr          , Wo          , Wo          , Wo          , Wo          , Ds          , Dd^Vda      , Ds          , Ds          , Gg          , Ds          , Ds          , Ds          , Ds          , Gg          , Gg          , Ds          , Gs^Fp       , Gg^Vh       , Gg          , Gg          , Hh          
Gs^Fp       , Gs^Fp       , Gg          , Gs^Fp       , Gs^Fp       , Gg          , Gs^Fp       , Gs^Fp       , Gs^Fp       , Gs^Fp       , Gg          , Ss          , Ss          , Ds          , Gg          , Gg          , Gg          , Gg          , Gg          , Gg          , Gs^Fp       , Gg          , Gg          , Gg          , Hh          , Hh          , Hh          , Hh          , Rr          , Rr          , Gg          , Wo          , Wo          , Wo          , Wo          , Wo          , Wo          , Wo          , Wo          , Ds          , Gg          , Gs^Fp       , Ss          , Ds          , Gg          , Gg          , Gg          , Gs^Fp       , Gg          , Gg          , Gg          , Gg          
Gs^Fp       , Gg          , Gs^Fp       , Gs^Fp       , Gs^Fp       , Gs^Fp       , Gs^Fp       , Gs^Fp       , Gg          , Gg          , Gg          , Ss          , Ss          , Ds          , Gg          , Gg          , Gg          , Gg          , Gg          , Gg          , Ds          , Gs^Fp       , Gg          , Gg          , Gg          , Hh          , Gg          , Gg          , Rr          , Gg          , Gg          , Ds          , Ds          , Ds          , Wo          , Wo          , Wo          , Wo          , Wo          , Ds          , Gg          , Gg          , Gs^Fp       , Ds          , Gg          , Gg          , Gg          , Ds          , Ce          , Ce          , Ce          , Gg          
Ss          , Ss          , Ds          , Gs^Fp       , Gg          , Gs^Fp       , Gs^Fp       , Gg          , Gg          , Gg          , Gg          , Ss          , Ss          , Ds          , Gg          , Gg          , Gg          , Gg          , Gg          , Gg          , Ds          , Ss          , Gg          , Gg          , Gg          , Gg          , Gg          , Gg          , Gg          , Rr          , Rr          , Gg          , Gg          , Ds          , Wo          , Wo          , Wo          , Wo          , Wo          , Gg          , Gg          , Gg^Vh       , Gg          , Ds          , Gg          , Gg          , Gg          , Ce          , Ce          , Ce          , Gg          , Gg          
Ss          , Ds          , Wo          , Ds          , Gg          , Gg          , Gs^Fp       , Gg          , Gg          , Gg          , Gg          , Gg          , Gs^Fp       , Ds          , Gg          , Gg          , Gg          , Gg          , Gg          , Gg          , Ds          , Ss          , Gs^Fp       , Gg          , Gg          , Gg          , Gg          , Gg          , Gg          , Gg          , Gg          , Rr          , Gg          , Ds          , Wo          , Wo          , Wo          , Wo          , Wo          , Gg          , Ds          , Ds          , Gs^Fp       , Gs^Fp       , Ds          , Gg          , Gg          , Ce          , 5 Ke        , Ds          , Gg          , Gg          
Ss          , Ds          , Wo          , Ds          , Gg          , Gg          , Gs^Fp       , Hh          , Hh          , Hh          , Hh          , Gg          , Gs^Fp       , Gs^Fp       , Gg          , Gg          , Gg          , Gg          , Gg          , Gg          , Ds          , Ds          , Gs^Fp       , Gg          , Gs^Fp       , Gs^Fp       , Gg          , Gs^Fp       , Gg          , Gg          , Gg          , Rr          , Gg          , Ds          , Ds          , Ds          , Wo          , Wo          , Wo          , Wo          , Wo          , Wo          , Ds          , Gs^Fp       , Ds          , Gg          , Gg          , Gg          , Gg          , Gg          , Gg          , Gg          
Ds          , Ds          , Wo          , Wo          , Gg          , Gg          , Gs^Fp       , Hh          , Mm          , Mm          , Hh          , Gs^Fp       , Gg          , Gg          , Gg          , Ds          , Gg          , Ds          , Gg          , Gg          , Ds          , Ss          , Gs^Fp       , Gs^Fp       , Gs^Fp       , Gs^Fp       , Gs^Fp       , Gs^Fp       , Gs^Fp       , Gs^Fp       , Rr          , Rr          , Gg          , Gg          , Gg          , Gs^Fp       , Wo          , Wo          , Gg          , Ds          , Gg          , Ds          , Gg          , Ds          , Gg          , Gg          , Gg          , Gg          , Gg          , Gg          , Gg          , Gg          
Ds          , Wo          , Wo          , Ds          , Gg          , Gg          , Hh          , Mm          , Mm          , Mm          , Mm          , Gs^Fp       , Gs^Fp       , Gs^Fp       , Gg          , Gs^Fp       , Gs^Fp       , Ss          , Ds          , Gg          , Ds          , Ss          , Gs^Fp       , Gs^Fp       , Gs^Fp       , Gs^Fp       , Gs^Fp       , Gs^Fp       , Gs^Fp       , Gs^Fp       , Rr          , Gs^Fp       , Gg          , Gg          , Gg          , Gs^Fp       , Wo          , Wo          , Gs^Fp       , Gg          , Gg          , Gs^Fp       , Gg          , Gg          , Gg          , Gg          , Gg          , Gg          , Gg          , Gg          , Gg          , Ds          
