border_size=1
usage=map

Gg          , Gg          , Gg          , Gg          , Hh          , Hh          , Mm          , Mm          , Mm          , Mm          , Mm          , Mm          , Mm          , Mm          , Hh          , Hh          , Hh          , Hh          , Rr          , Rr          , Gg          , Gg          , Gg          , Gg          , Gg          , Gg^Fdfz     , Gg^Fdfz     , Gg^Fdfz     , Gg^Fdfz     , Gg^Fdfz     , Gg^Fdfz     , Gg          , Gll^Fdfz    , Mm^Xm       , Mm^Xm       , Rr          , Rr          , Rr          , Rr          , Aa          , Aa          , Aa          , Gg          , Gg          , Gg          , Gg          , Gs^Fp       , Gs^Fp       , Gs^Fp       , Gs^Fp       , Ww          , Ww          
Gg          , Gg          , Gg          , Gg          , Hh          , Hh          , Mm          , Mm          , Mm          , Mm          , Mm          , Mm          , Mm          , Mm          , Hh          , Hh          , Hh          , Hh          , Rr          , Gg          , Gg          , Gg          , Gg          , Gg          , Gg^Fdfz     , Gg^Fdfz     , Gg^Fdfz     , Gg^Fdfz     , Gg^Fdfz     , Gg^Fdfz     , Hhd^Fdf     , Gll^Fdfz    , Gll^Fdfz    , Gll^Fdfz    , Gll^Fdfz    , Mm^Xm       , Mm^Xm       , Gg          , Rr          , Gg          , Gg          , Aa          , Gg          , Gg          , Gg          , Gg          , Gs^Fp       , Gs^Fp       , Gs^Fp       , Gs^Fp       , Ww          , Ww          
Gg          , Gs^Fp       , Gs^Fp       , Gs^Fp       , Hh          , Hh          , Hh          , Ha          , Mm          , Hh          , Hh          , Mm          , Mm          , Hh          , Hh          , Hh          , Hh          , Rr          , Gg          , Gg          , Gg          , Gg          , Gg          , Gg          , Gg^Fdfz     , Gg^Fdfz     , Gg^Fdfz     , Gg^Fdfz     , Gg^Fdfz     , Hhd^Fdf     , Hhd^Fdf     , Hhd^Fdf     , Gbx         , Gll^Fdfz    , Gll^Fdfz    , Gll^Fdfz    , Gll^Fdfz    , Mm^Xm       , Hh          , Rr          , Rr          , Aa          , Aa          , Aa          , Gg          , Gg          , Gg          , Gs^Fp       , Ww          , Ww          , Ww          , Ww          
Gg          , Gs^Fp       , Gs^Fp       , Gll^Fp      , Gll^Fp      , Gll^Fp      , Hh          , Hh          , Hh          , Hh          , Hh          , Hh          , Hh          , Hh          , Hh          , Hh          , Gs^Fp       , Rr          , Gg          , Gg          , Gg          , Gg          , Gg          , Gg          , Gg          , Gg^Fdfz     , Gg^Fdfz     , Gg^Fdfz     , Gg^Fdfz     , Hhd^Fdf     , Hhd^Fdf     , Hhd^Fdf     , Gbx         , 3 Gbx       , Gll^Fdfz    , Gll^Fdfz    , Gll^Fdfz    , Mm^Xm       , Md          , Hh          , Hh          , Rr          , Gg          , Aa          , Gg          , Gg          , Gg          , Ww          , Ww          , Ww          , Ww          , Ww          
Gg          , Gs^Fp       , Gll^Fp      , Gll^Fp      , Gll^Fp      , Gll^Fp      , Hh          , Ha          , Ha          , Hh          , Hh          , Gg          , Hh          , Gg          , Rr          , Rr          , Rr          , Rr          , Gg          , Gg          , Gg          , Gg          , Hh          , Gg          , Mm          , Gg^Fdfz     , Gg^Fdfz     , Gg^Fdfz     , Hh^Fdfz     , Hh^Fdfz     , Hh^Fdfz     , Hhd^Fdf     , Gbx         , Gbx         , Gll^Fdfz    , Gll^Fdfz    , Mm^Xm       , Mm^Xm       , Mm^Xm       , Md          , Md          , Rr          , Gg          , Gg          , Gg          , Gg          , Ww          , Ww          , Ww          , Ww          , Ww          , Ww          
Gg          , Gg          , Gll^Fp      , Gll^Fp      , Gs^Fp       , Rr          , Aa          , Rr          , Rr          , Gg          , Gg          , Gg          , Gg          , Gg          , Rr          , Ww          , Ww          , Gg          , Gg          , Gg          , Gg          , Hh          , Hh          , Mm          , Mm          , Mm          , Mm          , Gg^Fdfz     , Mm          , Gll^Fdfz    , Gll^Fdfz    , Gll^Fdfz    , Gll^Fdfz    , Gll^Fdfz    , Gll^Fdfz    , Gll^Fdfz    , Mm^Xm       , Mm^Xm       , Md          , Md          , Hh          , Rr          , Gg          , Gs^Fp       , Gg          , Ww          , Ww          , Ww          , Ww          , Ww          , Ww          , Ww          
Gg          , Gg          , Gg          , Gg          , Gg^Fp       , Aa          , Rr          , Rr          , Rr          , Rr          , Rr          , Gs^Fp       , Rr          , Rr          , Gg          , Ww          , Ww          , Ww          , Ww          , Gg          , Hh          , Hh          , Hh          , Mm          , Mm          , Mm          , Mm          , Mm          , Mm          , Mm          , Hh          , Gll^Fdfz    , Gll^Fdfz    , Gll^Fdfz    , Gll^Fdfz    , Gll^Fdfz    , Mm^Xm       , Mm^Xm       , Md          , Md          , Hh          , Rr          , Rr          , Gg          , Gs^Fp       , Ww          , Ww          , Gg          , Ww          , Ww          , Ww          , Ww          
Rr          , Gg          , Gg          , Gg          , Aa          , Gg          , Rr^Fp       , Gg          , Rr          , Gs^Fp       , Gg          , Rr          , Gs^Fp       , Gs^Fp       , Gg          , Ww          , Ww          , Ww          , Ww          , Ww          , Hh          , Hh          , Mm          , Mm          , Mm          , Mm          , Mm          , Mm          , Mm          , Mm          , Mm^Xm       , Mm^Xm       , Mm^Xm       , Mm^Xm       , Mm^Xm       , Mm^Xm       , Md          , Md          , Hh          , Hh          , Ds          , Ds          , Gg          , Rr          , Gs^Fp       , Gg          , Gg          , Aa          , Ai          , Ww          , Ww          , Ww          
Aa          , Aa          , Aa          , Aa          , Aa          , Rr          , Gg          , Gg          , Gs^Fp       , Rr          , Rr          , Gg          , Ww          , Gs^Fp       , Gg          , Ww          , Ww          , Ww          , Ww          , Gs^Fp       , Hh          , Hh          , Mm          , Mm          , Mm          , Mm          , Mm          , Mm          , Mm          , Mm          , Mm^Xm       , Md          , Mm^Xm       , Md          , Mm          , Mm          , Md          , Md          , Hh          , Hh          , Gg          , Ds          , Gg          , Rr          , Rr          , Gg          , Gg          , Aa          , Aa          , Ww          , Ww          , Ww          
Aa          , Aa          , Aa          , Aa          , Aa          , Rr          , Gg          , Gs^Fp       , Gs^Fp       , Gg          , Rr          , Gs^Fp       , Ww          , Ww          , Ww          , Ww          , Ww          , Ww          , Ww          , Hh          , Hh          , Hh          , Mm          , Mm          , Mm          , Mm          , Mm          , Mm          , Mm          , Mm          , Mm          , Mm^Xm       , Mm          , Mm          , Mm          , Mm          , Hh          , Hh          , Gs^Fp       , Gs^Fp       , Gg          , Gg          , Gg          , Gs^Fp       , Gs^Fp       , Rr          , Gg          , Aa          , Aa          , Ai          , Ww          , Gg          
Aa          , Gg          , Gg          , Gg          , Rr          , Rr          , Gg          , Gg          , Gs^Fp       , Gs^Fp       , Gs^Fp       , Rr          , Ww^Bw\      , Ww          , Ww          , Gg          , Ww          , Ww          , Ww          , Hh          , Hh          , Hh          , Mm          , Mm          , Mm          , Mm          , Mm          , Mm          , Mm          , Mm          , Mm          , Mm          , Mm          , Mm          , Hh          , Hh          , Hh          , Gg          , Gg          , Gs^Fp       , Gs^Fp       , Gg          , Gg          , Gs^Fp       , Gs^Fp       , Rr          , Rr          , Aa          , Gg          , Ww          , Ww          , Ai          
Rr          , Rr          , Rr          , Rr          , Gg          , Gg          , Gg          , Gg          , Gg          , Gs^Fp       , Gs^Fp       , Gg          , Ww          , Rr          , Aa          , Aa          , Ww          , Ww          , Hh          , Hh          , Mm          , Mm          , Mm          , Mm          , Mm          , Mm          , Mm          , Mm          , Mm          , Mm          , Mm          , Md          , Hh          , Hh          , Hh          , Hh          , Gg          , Gg          , Gg          , Gg          , Gg          , Gs^Fp       , Gg          , Gs^Fp       , Gs^Fp       , Gs^Fp       , Rr          , Aa          , Gg          , Ww          , Ww          , Ai          
Rr          , Ww          , Ww          , Gg          , Gg          , Gg          , Gg          , Gg          , Ww          , Ww          , Ww          , Gg          , Ww          , Rr          , Ai          , Ww          , Ww          , Hh          , Hh          , Hh          , Mm          , Mm          , Mm          , Mm          , Mm          , Mm          , Mm          , Mm          , Mm          , Mm          , Mm          , Hh          , Hh          , Hh          , Hh          , Hh          , Gg          , Gg          , Gg          , Gg          , Gs^Fp       , Gs^Fp       , Gs^Fp       , Gs^Fp       , Ss          , Gs^Fp       , Rr          , Gg          , Gg          , Ww          , Ww          , Ai          
Rr          , Gg          , Ww          , Gg          , Gg          , Gg          , Ww          , Ww          , Gg          , Gg          , Ww          , Gg          , Ai          , Rr          , Ww          , Ww          , Ww          , Ww          , Hh          , Mm          , Mm          , Mm          , Mm          , Mm          , Mm          , Mm          , Mm          , Mm          , Mm          , Mm          , Mm          , Hh          , Hh          , Hh          , Hh          , Hh          , Gg          , Gg          , Gg          , Gg          , Gs^Fp       , Gs^Fp       , Gs^Fp       , Gs^Fp       , Gs^Fp       , Gg          , Gg          , Rr          , Gg          , Ww          , Ww          , Ww          
Rr          , Ww          , Ww          , Gg          , Gg          , Gg          , Ww          , Ww          , Ww          , Ww          , Ww          , Ww          , Aa          , Rr          , Rr          , Hh          , Hh          , Ww          , Ww          , Mm          , Mm          , Mm          , Mm          , Mm          , Mm          , Mm          , Mm          , Mm          , Mm          , Mm          , Hh          , Hh          , Hh          , Hh          , Hh          , Gs^Fp       , Gg          , Gg          , Gg          , Gg          , Gs^Fp       , Gs^Fp       , Gs^Fp       , Gg          , Gs^Fp       , Gll^Fp      , Gll^Fp      , Rr          , Gg          , Ww          , Ww          , Ww          
Rr          , Ww          , Ww          , Ww          , Ai          , Gg          , Ww          , Ww          , Ww          , Ww          , Ww          , Ww          , Aa          , Gg          , Rr          , Hh          , Hh          , Ww          , Ww          , Mm          , Mm          , Mm          , Mm          , Mm          , Mm          , Mm          , Hh          , Hh          , Hh          , Hh          , Hh          , Hh          , Hh          , Gs^Fp       , Gs^Fp       , Gs^Fp       , Rr          , Gg          , Gg          , Gg          , Rr          , Rr          , Rr          , Gg          , Rr          , Gg          , Gll^Fp      , Rr          , Gg          , Ww          , Ww          , Ww          
Ww^Bw\      , Ww          , Ai          , Ai          , Ai          , Ww          , Ww          , Ww          , Ww          , Gg          , Gg^Efm      , Aa^Vla      , Hh          , Ha          , Hh          , Rr          , Rr          , Hh          , Ww          , Hh          , Hh          , Hh          , Hh          , Hh          , Hh          , Hh          , Hh          , Hh          , Hh          , Hh          , Hh          , Gg          , Gg          , Gg          , Rr          , Rr          , Gg          , Rr          , Rr          , Rr          , Gg          , Gg          , Gg          , Rr          , Aa          , Rr          , Rr          , Rr          , Ww          , Ww          , Ww          , Ww          
Ww          , Ww^Bw\      , Ww^Bw\      , Ai          , Ww          , Gg          , Gg^Efm      , Gs^Fp       , Gg^Efm      , Gg          , Rr^Vhc      , Aa^Vha      , Hh          , Hh          , Ha          , Hh          , Rr          , Hh          , Rr          , Ww          , Rr          , Rr          , Rr          , Hh          , Gs^Fp       , Gg          , Gg          , Gg          , Rr          , Aa          , Aa          , Gg          , Gg          , Rr          , Gg          , Gg          , Gg          , Gg          , Gg          , Gg          , Gg          , Gg          , Aa          , Aa          , Aa          , Aa          , Gg          , Rr          , Ww          , Ww          , Ww          , Ww          
Mm          , Ww          , Mm          , Rr          , Ww^Bw\      , Hh          , Rr          , Rr          , Rr          , Gg          , Hh^Vhh      , Hh^Vhh      , Hh          , Hh          , Rr          , Rr          , Mm          , Rr          , Hh          , Rr          , Ww          , Hh          , Ww          , Rr          , Rr          , Rr          , Rr          , Rr          , Gg          , Rr          , Rr          , Gg          , Rr          , Rr          , Gg          , Gg          , Gg          , Gg          , Gg          , Gg          , Gg          , Gg          , Aa          , Gg          , Gg          , Gg          , Gg          , Rr          , Ww          , Ww          , Ww          , Ww          
Mm          , Mm          , Mm          , Mm          , Gg^Gvs      , Rr          , Gg^Efm      , Gs^Vh       , Rrc^Cov     , Rr          , Rr          , Gg^Efm      , Hh          , Hh          , Rr          , Hh          , Ww          , Ww          , Ww          , Hh          , Ww          , Ww          , Gs^Fp       , Ww          , Ww          , Gg          , Gg          , Gg          , Gg          , Gg          , Gg          , Rr          , Gg          , Gg          , Gg          , Aa          , Gg          , Gg          , Gg          , Gg          , Gg          , Gg          , Gg          , Gg          , Gg          , Gg          , Gg          , Rr          , Gg          , Ww          , Ww          , Ww          
Mm          , Gg^Efm      , Gg^Gvs      , Gg^Gvs      , Gg^Gvs      , Gs^Vh       , Rr^Vhc      , Rrc^Cov     , 2 Rrc^Kov   , Rrc^Cov     , Rr^Vhc      , Rr          , Rr          , Rr          , Hh          , Hh          , Ww          , Ww          , Ww          , Ww          , Ww          , Ww          , Ww          , Gs^Fp       , Ww          , Gg          , Gs^Fp       , Gs^Fp       , Gs^Fp       , Gg          , Gg          , Gg          , Gs^Fp       , Gg          , Gg          , Aa          , Aa          , Gg          , Gg          , Gg          , Gg          , Gg          , Gg          , Gg          , Gg          , Gg          , Gg          , Rr          , Rr          , Gg          , Ww^Bw/      , Rr          
Mm          , Mm          , Mm          , Gg^Gvs      , Gg^Gvs      , Gs^Vh       , Gs^Vh       , Rrc^Cov     , Rr^Vhc      , Rrc^Cov     , Gs^Vh       , Rr^Vhc      , Hh          , Rr          , Rr          , Hh          , Ww          , Ww          , Hh          , Ww          , Ww          , Gg          , Ww          , Ww          , Ww          , Ww          , Ww          , Gs^Fp       , Ww          , Gs^Fp       , Gg          , Gg          , Gg          , Gg          , Gg          , Aa          , Aa          , Gg          , Gg          , Gg          , Gg          , Gg          , Gg          , Gg          , Gg          , Gs^Fp       , Gg          , Gg          , Gg          , 1 Rr        , Ww          , Gg          
Mm          , Mm          , Mm          , Gg^Gvs      , Gg^Gvs      , Gg^Gvs      , Gg          , Gs^Fp       , Gg^Gvs      , Gg^Gvs      , Gg^Gvs      , Gg^Gvs      , Gg          , Gg^Efm      , Gg^Gvs      , Rr          , Rr          , Hh          , Rr          , Ww          , Ww          , Ww          , Ww          , Ww          , Ww          , Ww          , Ww          , Ww          , Gs^Fp       , Ww          , Ww          , Ww          , Ww          , Gg          , Gg          , Aa          , Aa          , Ww          , Ww          , Gg          , Gg          , Gg          , Gg          , Gg          , Gg          , Gg          , Gg          , Gg          , Gg          , Gg          , Ww          , Gg          
Mm          , Mm          , Mm          , Gg^Gvs      , Gg          , Gg          , Gg          , Gg^Gvs      , Gg^Gvs      , Gg^Gvs      , Gg          , Gg^Efm      , Gg^Gvs      , Gg^Gvs      , Gg^Gvs      , Gg^Gvs      , Gg          , Rr          , Hh          , Ww^Bw\      , Rr          , Ww          , Gs^Fp       , Gg          , Gg          , Gs^Fp       , Gs^Fp       , Gs^Fp       , Gs^Fp       , Gg          , Gg          , Gg          , Ww          , Gg          , Gg          , Gg          , Gg          , Ww          , Ai          , Gg          , Gg          , Gg          , Gs^Fp       , Gs^Fp       , Gg          , Gg          , Gg          , Gg          , Gg          , Gg          , Ww          , Gg          
