border_size=1
usage=map

Wot         , Wot         , Wot         , Wot         , Wot         , Wot         , Wot         , Wot         , Wot         , Wot         , Wot         , Wot         , Wot         , Wot         , Wot         , Wot         , Wot         , Wot         , Wot         , Wot         , Wot         , Wot         , Wot         , Wot         , Wot         , Wot         , Wot         , Wot         , Wot         , Wot         , Wot         , Wot         , Wot         , Wot         , Wot         , Wot         , Wot         , Wot         , Wot         , Wot         , Wot         , Wot         , Wot         , Wot         , Wot         , Wot         , Wot         , Wot         , Wot         , Wot         , Wot         , Wot         
Wot         , Wot         , Wot         , Wot         , Wot         , Wot         , Wot         , Wot         , Wot         , Wot         , Wot         , Wot         , Wot         , Wot         , Wot         , Wot         , Wot         , Wot         , Wot         , Wot         , Wot         , Wot         , Wot         , Wot         , Wot         , Wot         , Wot         , Wot^Cov     , 3 Wot^Kov   , Wot^Cov     , Wot         , Wot         , Wot         , Wot         , Wot         , Wot         , Wot         , Wot         , Wot         , Wot         , Wot         , Wot         , Wot         , Wot         , Wot         , Wot         , Wot         , Wot         , Wot         , Wot         , Wot         , Wot         
Wot         , Wot         , Wot         , Wot         , Wot         , Wot         , Wot         , Wot         , Wot         , Wot         , Wot         , Wot         , Wot         , Wot         , Wot         , Wot         , Wot         , Wot         , Wot         , Wot         , Wot         , Wot         , Ss          , Wot         , Ss          , Wot         , Wot         , Wot^Cov     , Wot         , Wot^Cov     , Wot         , Wot         , Wot         , Wot         , Wot         , Wot         , Ds          , Wot         , Wot         , Wot         , Wot         , Wot         , Wot         , Wot         , Wot         , Wot         , Wot         , Wot         , Wot         , Wot         , Wot         , Wot         
Ds          , Wot         , Ds          , Ds          , Ds          , Ds          , Ds          , Wot         , Wot         , Wot         , Wot         , Wot         , Ds          , Ds          , Ds          , Ds          , Ds          , Wot         , Ss          , Ss          , Sm          , Sm          , Ss          , Ss          , Ss          , Ss          , Sm          , Wot         , Sm          , Wot         , Gs          , Gs          , Gs          , Ds          , Ds          , Ds          , Hhd^Fdw     , Ds          , Ds          , Wot         , Wot         , Wot         , Wot         , Wot         , Wot         , Wot         , Wot         , Wot         , Ss          , Hh          , Hh          , Hh          
Hh          , Ds          , Gs          , Ds          , Hhd         , Ds          , Ds          , Ss          , Ss          , Wot         , Ss          , Ss          , Hhd         , Hhd^Fdw     , Hhd^Fdw     , Hhd^Fdw     , Hhd         , Ss          , Ss          , Ss          , Sm          , Sm          , Sm          , Ss          , Ss          , Ss          , Sm          , Sm          , Sm          , Ss          , Ss          , Ss          , Ss          , Ds          , Ds          , Hhd^Fdw     , Hhd^Fdw     , Hhd^Fdw     , Ds          , Ss          , Ss          , Wot         , Ss          , Wot         , Ss          , Wot         , Ss          , Gg          , Ss          , Ss          , Ss          , Mm          
Gs          , Gs          , Gs          , Gs          , Hhd         , Ds          , Ds          , Ss          , Ss          , Sm          , Ss          , Ss          , Hhd^Fdw     , Hhd^Fdw     , Hhd^Fdw     , Hhd         , Ds          , Ss          , Ss          , Ss          , Ss          , Sm          , Ss          , Ss          , Ds          , Ds          , Sm          , Sm          , Sm          , Ss          , Ss          , Ss          , Ds          , Ds          , Ds          , Ds          , Ds          , Hhd^Fdw     , Ds          , Ds          , Ss          , Wot         , Wot         , Ss          , Ds          , Ds          , Ds          , Ss          , Ss          , Ss          , Ss          , Mm          
Gs          , Gs          , Gs          , Gs          , Ds          , Ds          , Ds          , Ss          , Ss          , Sm          , Ss          , Ss          , Ds          , Hhd^Fdw     , Ds          , Ds          , Ss          , Ss          , Gs^Vc       , Ss          , Ss          , Ss          , Ss          , Hhd         , Hhd^Fdw     , Ds          , Ds          , Sm          , Sm          , Sm          , Ss          , Ss          , Gs^Vc       , Ds          , Ds          , Ds          , Ds          , Ds          , Ss          , Ss          , Ss          , Ss          , Wot         , Ds          , Gs^Fdw      , Gs^Fdw      , Ds          , Ss          , Ss          , Ss          , Ss          , Hh          
Gs          , Gs          , Gs          , Ds          , Ds          , Ds          , Ss          , Ss          , Wwt         , Wwt         , Ss          , Ss          , Ss          , Ds          , Ds          , Ds          , Ss          , Ss          , Ss          , Ss          , Ss          , Ss          , Hhd         , Hhd         , Hhd^Fdw     , Hhd^Fdw     , Hhd^Fdw     , Ds          , Ss          , Sm          , Ss          , Ss          , Ds          , Ds          , Ds          , Ds          , Ds          , Ds          , Ss          , Sm          , Sm          , Wot         , Sm          , Ds          , Ds          , Gs^Fdw      , Gs^Fdw      , Ds          , Ds          , Ss          , Ss          , Ss          
Gs          , Gs          , Gs          , Ds          , Ds          , Ss          , Ss          , Wwt         , Wwt         , Wwt         , Ss          , Ss          , Ss          , Ss          , Wwt         , Wwt         , Sm          , Sm          , Sm          , Ss          , Ss          , Ss          , Ss          , Ds          , Hhd^Fdw     , Hhd^Fdw     , Gs^Vc       , Ds          , Ss          , Sm          , Wwt         , Ss          , Ds          , Ds          , Hhd^Fdw     , Ds          , Ds          , Ds          , Ss          , Sm          , Sm          , Sm          , Sm          , Ds          , Ds          , Ds          , Ds          , Gs^Fdw      , Ds          , Ss          , Ss          , Ss          
Gs          , Gs          , Gs          , Ds          , Gs          , Gs          , Ss          , Wwt         , Wwt         , Wwt         , Wwt         , Ss          , Sm          , Sm          , Wwt         , Wwt         , Sm          , Sm          , Sm          , Wwt         , Wwt         , Ss          , Ss          , Ds          , Hhd^Fdw     , Hhd^Fdw     , Ds          , Ds          , Ss          , Wwt         , Wwt         , Ss          , Wwt         , Hhd         , Hhd^Fdw     , Hhd^Fdw     , Hhd^Fdw     , Ds          , Ds          , Ss          , Sm          , Sm          , Sm          , Ds          , Gs          , Ds          , Ds          , Ds          , Ds          , Ss          , Gs          , Ss          
Gs          , Gs          , Gs          , Ds          , Ds          , Ss          , Ss          , Ss          , Wwt         , Wwt         , Wwt         , Sm          , Sm          , Sm          , Sm          , Ss          , Ss          , Sm          , Wwt         , Wwt         , Wwt         , Wwt         , Ss          , Ds          , Ds          , Ds          , Ss          , Ss          , Ss          , Wwt         , Wwt         , Wwt         , Ss          , Ss          , Ds          , Hhd         , Ds          , Hhd         , Gs^Vc       , Ss          , Ss          , Sm          , Wwt         , Ds          , Gs          , Gs          , Gs          , Gs          , Gs          , Gs          , Gs          , Gs          
Gs          , Gs          , Gs          , Ds          , Ds          , Ss          , Ss          , Gs^Fdw      , Wwt         , Wwt         , Wwt         , Wwt         , Ss          , Sm          , Ss          , Ss          , Ss          , Ss          , Ss          , Wwt         , Wwt         , Wwt         , Sm          , Sm          , Sm          , Ss          , Ss          , Ss          , Ss          , Ss          , Ss          , Ss          , Ss          , Ss          , Ss          , Ds          , Ss          , Ss          , Ss          , Ss          , Ss          , Gs          , Gs          , Wwt         , Gs          , Gs          , Gs          , Gs          , Gs          , 1 Gs        , Gs          , Gs          
Gs          , Gs          , Gs          , Ds          , Ds          , Ss          , Ss          , Gs^Fdw      , Wwt         , Wwt         , Wwt         , Ss          , Ss          , Ss          , Ss          , Ds          , Ds          , Ds          , Ss          , Ss          , Ss          , Sm          , Sm          , Sm          , Sm          , Sm          , Sm          , Ss          , Ss          , Ss          , Ss          , Ss          , Ss          , Gs          , Ss          , Ss          , Ss          , Ss          , Ss          , Sm          , Sm          , Ss          , Sm          , Wwt         , Wwt         , Gs          , Gs          , Gs          , Gs          , Gs          , Gs          , Gs          
Gs          , Gs          , Ds          , Ds          , Ss          , Ss          , Ds          , Ss          , Wwt         , Wwt         , Ss          , Ss          , Ss          , Ss          , Ds          , Ds          , Hhd^Fdw     , Ds          , Ds          , Ss          , Ds          , Ds          , Ss          , Sm          , Sm          , Sm          , Sm          , Sm          , Wwt         , Wwt         , Wwt         , Wwt         , Gs          , Gs          , Gs          , Ss          , Ss          , Ss          , Ss          , Ss          , Sm          , Sm          , Ss          , Ss          , Wwt         , Gs          , Gs          , Gs          , Gs^Fdw      , Gs^Fdw      , Rr          , Rr          
Rr          , Rr          , Ds          , Ds          , Ss          , Ss          , Ds          , Ds          , Ds          , Ds          , Ds          , Ss          , Ss          , Ss          , Ds          , Ds          , Hhd^Fdw     , Hhd^Fdw     , Hhd^Fdw     , Ds          , Hhd^Fdw     , Ds          , Hhd^Fdw     , Hhd         , Hhd         , Sm          , Ss          , Sm          , Ss          , Wwt         , Sm          , Sm          , Sm          , Sm          , Sm          , Sm          , Sm          , Sm          , Sm          , Ss          , Sm          , Sm          , Ss          , Ss          , Wwt         , Wwt         , Wwt         , Gs          , Gs^Fdw      , Gs^Fdw      , Rr          , Gs^Fdw      
Gs          , Rr          , Rr          , Ds          , Ds          , Ss          , Ds          , Gs^Fdw      , Gs^Fdw      , Ds          , Ds          , Ds          , Ds          , Gs          , Hh          , Hhd^Fdw     , Hhd^Fdw     , Hhd^Fdw     , Hhd^Fdw     , Hhd^Fdw     , Hhd^Fdw     , Hhd^Fdw     , Hhd^Fdw     , Hhd         , Hhd         , Ds          , Ss          , Ss          , Ss          , Wwt         , Wwt         , Wwt         , Wwt         , Sm          , Sm          , Sm          , Wwt         , Sm          , Sm          , Ss          , Ss          , Ss          , Ss          , Ss          , Wwt         , Wwt         , Gs          , Gs          , Gs^Fdw      , Rr          , Gs^Fdw      , Gs^Fdw      
Gs          , Gs          , Gs          , Rr          , Rr          , Ds          , Ds          , Gs^Fdw      , Gs^Fdw      , Gs^Fdw      , Gs^Fdw      , Ds          , Ss          , Ss          , Gs          , Hhd^Fdw     , Hhd^Fdw     , Hhd^Fdw     , Hhd^Fdw     , Hhd^Fdw     , Hhd^Fdw     , Hhd^Fdw     , Hhd         , Hhd         , Co          , Ds          , Ds          , Ds          , Ds          , Ss          , Ss          , Ss          , Wwt         , Wwt         , Wwt         , Wwt         , Wwt         , Wwt         , Wwt         , Ss          , Ss          , Ss          , Sm          , Sm          , Sm          , Wwt         , Gs          , Gs^Fdw      , Gs^Fdw      , Rr          , Gs^Fdw      , Gs^Fdw      
Gs          , Gs          , Gs          , Gs          , Gs          , Rr          , Rr          , Rr          , Rr          , Gs^Fdw      , Gs^Fdw      , Ss          , Ss          , Ss          , Gs          , Hhd         , Hhd^Fdw     , Hhd^Fdw     , Hhd^Fdw     , Hhd^Fdw     , Hhd^Fdw     , Hhd         , Ss          , Co          , 2 Ko        , Co          , Co          , Ds          , Ds          , Ds          , Ss          , Ss          , Ss          , Ss          , Ss          , Wwt         , Wwt         , Wwt         , Wwt         , Ss          , Ss          , Sm          , Sm          , Sm          , Sm          , Ds          , Gs^Fdw      , Gs^Fdw      , Rr          , Rr          , Gs^Fdw      , Gs^Fdw      
Gs          , Gs          , Gs          , Gs          , Gs          , Ss          , Gs^Vc       , Ss          , Ss          , Rr          , Rr          , Ss          , Ss          , Ss          , Ss          , Hhd         , Hhd^Fdw     , Hhd^Fdw     , Hhd^Fdw     , Hhd^Fdw     , Hhd^Fdw     , Hhd         , Ss          , Gs          , Gs          , Co          , Co          , Ds          , Ds          , Ss          , Ss          , Ss          , Ss          , Ss          , Ss          , Ss          , Wwt         , Wwt         , Wwt         , Wwt         , Wwt         , Wwt         , Wwt         , Sm          , Ds          , Ds          , Gs^Fdw      , Gs^Fdw      , Rr          , Gs^Fdw      , Gs^Fdw      , Gs^Fdw      
Gs          , Gs          , Gs          , Gs          , Gs          , Gs          , Gs          , Gs^Vc       , Gs          , Gs^Vc       , Ss          , Rr          , Rr          , Ss          , Rr          , Hhd         , Rr          , Hhd^Fdw     , Rr          , Ss          , Rr          , Rr          , Rr          , Rr          , Rr          , Rr          , Rr          , Ds          , Re          , Gs^Fp       , Gs^Fp       , Ss          , Ss          , Ss          , Rr          , Ss          , Rr          , Wwt         , Wwt         , Wwt         , Wwt         , Wwt         , Wwt         , Ds          , Gs          , Gs^Fdw      , Rr          , Rr          , Gs          , Gs          , Gs          , Gs          
Gs          , Gs          , Gs          , Gs          , Gs          , Gs          , Gs          , Gs          , Gs          , Gs          , Gs          , Gs          , Gs          , Rr          , Gs          , Rr          , Gs          , Rr          , Gs          , Rr          , Gs          , Gs          , Gs          , Gs          , Gs          , Gs          , Gs          , Rr          , Rr          , Rr          , Rr          , Rr          , Rr          , Rr          , Gs          , Rr          , Gs          , Rr          , Rr          , Rr          , Rr          , Rr          , Rr          , Rr          , Rr          , Rr          , Rr          , Rr          , Rr          , Rr          , Rr          , Gs          
Gs          , Gs          , Gs          , Gs          , Gs          , Gs          , Gs          , Gs          , Gs          , Gs          , Gs          , Gs          , Gs          , Gs          , Gs          , Gs          , Gs          , Gs          , Gs          , Gs          , Gs          , Gs          , Gs          , Gs          , Gs          , Gs          , Gs          , Gs          , Gs          , Gs          , Gs          , Gs          , Gs          , Gs          , Gs          , Gs          , Gs          , Gs          , Gs          , Gs          , Gs          , Gs          , Gs          , Gs          , Gs          , Gs          , Gs          , Gs          , Gs          , Gs          , Gs          , Rr          
