border_size=1
usage=map

Gg          , Md          , Md          , Md          , Md          , Md          , Md          , Mm          , Mm          , Mm          , Mm          , Mm          , Mm          , Mm          , Md          , Md          , Mm          , Rr          , Mm          , Wo          , Wo          , Wo          
Md          , Md          , Md          , Md          , Md          , Md          , Md          , Mm          , Mm          , Mm          , Md          , Md          , Md          , Md          , Hh^Fp       , Mm          , Mm          , Mm          , Mm          , Mm          , Wog         , Mm          
Md          , Md          , Md          , Ch          , Ch          , Ch          , Md          , Hh^Fp       , Md          , Md          , Mm          , Mm          , Hh^Fp       , Hh^Fp       , Hh^Fp       , Hh^Fp       , Hh^Fp       , Hh^Fp       , Rr          , Rr          , Mm          , Mm          
Md          , Md          , Ch          , Ch          , Ch          , Ch          , Hh^Fds      , Md          , Mm          , Mm          , Mm          , Mm          , Mm          , Mm          , Mm          , Hh^Fp       , Mm          , Hh^Fp       , Rr          , Mm          , Mm          , Mm          
Md          , Md          , Ch          , Ch          , Kh          , Ch          , Hh^Fds      , Hh^Fds      , Mm          , Mm          , Mm          , Mm          , Gbz         , Mm          , Hh^Fp       , Mm          , Mm          , Gbz         , Rr          , Mm          , Mm          , Mm          
Md          , Md          , Ch          , Ch          , Ch          , Rrc         , Hh^Fds      , Mm          , Mm          , Mm          , Mm          , Mm          , Hh          , Hh          , Hh          , Hh^Fp       , Mm          , Mm          , Rr          , Mm          , Mm          , Mm          
Md          , Md          , Md          , Hh^Fds      , Hh^Fds      , Rrc         , Hh^Fds      , Hh^Fds      , Mm          , Mm          , Mm          , Mm          , Mm          , Hh          , Hh          , Mm          , Mm          , Mm          , Rr          , Mm          , Mm          , Mm          
Md          , Md          , Md          , Hh^Fds      , Hh^Fds      , Rrc         , Md          , Mm          , Mm          , Mm          , Hh^Fp       , Mm          , Mm          , Mm          , Hh          , Mm          , Rr          , Rr          , Mm          , Mm          , Mm^Vhh      , Mm          
Md          , Md          , Md          , Md          , Md          , Rrc         , Rrc         , Mm          , Mm          , Mm          , Mm          , Mm          , Mm          , Mm          , Rr          , Rr          , Mm          , Mm          , Mm          , Mm          , Mm          , Mm          
Md          , Md          , Md          , Md          , Md          , Mm          , Mm          , Rrc         , Rrc         , Mm          , Mm          , Mm          , Mm          , Rr          , Hh          , Hh          , Gbz         , Mm          , Mm          , Mm          , Mm          , Mm          
Md          , Md          , Md          , Md          , Md          , Mm          , Mm          , Mm          , Mm          , Rrc         , Rrc         , Mm^Vhh      , Rr          , Rr          , Mm          , Mm          , Mm          , Mm          , Hh^Fp       , Mm          , Mm          , Mm          
Md          , Md          , Md          , Md          , Mm          , Mm          , Mm          , Mm          , Mm          , Mm          , Mm          , Rr          , Hh^Fds      , Hh^Fds      , Mm          , Mm          , Mm          , Mm          , Mm          , Hh^Fp       , Mm          , Mm          
Mm          , Mm          , Mm          , Mm          , Mm          , Mm          , Mm          , Mm          , Mm          , Mm          , Mm          , Rr          , Mm          , Mm          , Mm          , Mm          , Mm          , Mm          , Mm          , Mm          , Mm          , Mm          
Mm          , Mm          , Mm          , Mm          , Mm          , Mm          , Mm          , Mm          , Mm          , Mm          , Rr          , Rr          , Mm          , Mm          , Mm          , Mm          , Mm          , Mm          , Mm          , Mm          , Mm          , Mm          
Mm          , Mm          , Mm          , Mm          , Mm          , Mm          , Mm          , Mm          , Mm          , Mm          , Rr          , Mm          , Mm          , Mm          , Mm          , Mm          , Mm          , Mm          , Mm          , Mm          , Mm          , Mm          
Mm          , Mm          , Mm          , Mm          , Mm          , Mm          , Mm          , Mm          , Mm          , Gbz         , Rr          , Mm          , Mm          , Mm          , Mm          , Mm          , Mm          , Mm          , Mm          , Mm          , Mm          , Mm          
Mm          , Mm          , Mm          , Mm          , Mm          , Mm          , Mm          , Mm          , Mm          , Rr          , Hh^Fds      , Hh^Fds      , Hh          , Mm          , Mm          , Mm          , Hh^Fds      , Hh^Fds      , Hh^Fds      , Hh          , Mm          , Mm          
Mm          , Mm          , Mm          , Mm          , Mm          , Mm          , Mm          , Mm          , Mm          , Rr          , Mm          , Mm          , Mm          , Hh^Fds      , Hh^Fp       , Hh^Fds      , Mm          , Hh^Fp       , Mm          , Mm          , Mm          , Mm          
Mm          , Mm          , Mm          , Mm          , Mm          , Mm          , Mm          , Mm          , Rr          , Rr          , Mm          , Mm          , Mm          , Mm          , Gbz         , Mm          , Mm          , Mm          , Mm          , Mm          , Mm          , Mm          
Mm          , Mm          , Mm          , Mm          , Mm          , Mm          , Rr          , Rr          , Mm          , Mm          , Mm          , Mm          , Mm          , Mm          , Hh^Fp       , Mm          , Mm          , Mm          , Mm          , Mm          , Mm          , Rrc         
Mm          , Mm          , Hh^Fds      , Mm          , Mm          , Rr          , Hh^Fds      , Mm          , Mm          , Gbz         , Hh          , Mm          , Mm          , Hh^Fp       , Hh^Fp       , Mm          , Mm          , Mm          , Mm          , Mm          , Rrc         , Rrc         
Mm          , Mm          , Mm          , Hh^Fds      , Rr          , Rr          , Mm          , Mm          , Mm          , Mm          , Mm          , Hh          , Hh          , Mm          , Mm          , Mm          , Mm          , Mm          , Mm          , Mm          , Rrc         , Mm          
Mm          , Mm          , Mm          , Rr          , Mm          , Mm          , Mm          , Mm          , Mm          , Mm          , Mm          , Mm          , Hh^Fds      , Hh          , Mm          , Mm          , Gbz         , Mm          , Rrc         , Rrc         , Mm          , Mm          
Mm          , Mm          , Rr          , Rr          , Mm          , Mm          , Mm          , Mm          , Mm          , Mm          , Mm          , Mm          , Mm          , Hh          , Rrc         , Rrc         , Rrc         , Rrc         , Rb          , Mm          , Mm          , Mm          
Rr          , Rr          , Gbz         , Mm          , Mm          , Mm          , Mm          , Mm          , Mm          , Mm          , Mm          , Mm          , Rrc         , Rrc         , Rb          , Rb          , Rb          , Rb          , 3 Rb        , Rb          , Mm          , Mm          
Rr          , Rr          , Rr          , Mm          , Mm          , Mm          , Mm          , Mm          , Mm          , Mm          , Mm^Vhh      , Rrc         , Rrc         , Rb          , Rb          , Rb          , Rb          , Rb          , Rb          , Rb          , Mm          , Mm          
Rr          , Mm          , Mm          , Rr          , Rr          , Rr          , Rr          , Mm          , Rr          , Mm          , Rrc         , Rrc         , Mm          , Rb          , Rb          , Rb          , Rb          , Co          , Rb          , Mm          , Mm          , Mm          
Mm          , Mm          , Mm          , Mm          , Mm          , Rr          , Mm          , Rr          , Rr          , Rr          , Mm          , Mm          , Mm          , Mm          , Mm          , Rb          , Rb          , Rb          , Mm          , Gbz         , Mm          , Mm          
Mm          , Mm          , Mm          , Mm          , Mm          , Mm          , Mm          , Mm          , Rr          , Hh^Fp       , Mm          , Mm          , Mm          , Mm          , Mm          , Mm          , Hh^Fp       , Mm          , Mm          , Mm          , Mm          , Mm          
Mm          , Mm          , Mm          , Mm          , Mm          , Mm          , Mm          , Mm          , Rr          , Hh^Fp       , Mm          , Mm          , Mm          , Mm          , Mm          , Hh^Fp       , Hh^Fp       , Mm          , Mm          , Mm          , Mm          , Mm          
Mm          , Mm          , Mm          , Mm          , Mm          , Mm          , Mm          , Mm          , Mm          , Rr          , Mm          , Mm          , Mm          , Mm          , Hh^Fp       , Hh^Fp       , Hh^Fp       , Mm          , Mm          , Mm          , Mm          , Mm          
Mm          , Mm          , Mm          , Mm          , Mm          , Mm          , Mm          , Gbz         , Rr          , Rr          , Mm          , Mm          , Mm          , Mm          , Mm          , Hh^Fp       , Hh^Fp       , Mm          , Mm          , Mm          , Mm          , Mm          
Mm          , Mm          , Mm          , Mm          , Mm          , Mm          , Mm          , Mm          , Rr          , Hh          , Hh          , Mm          , Mm          , Mm          , Mm          , Mm          , Mm          , Hh^Fp       , Mm          , Mm          , Mm          , Mm          
Mm          , Mm          , Mm          , Mm          , Hh          , Hhd^Vhhr    , Hh          , Rr          , Hh          , Hh          , Hh          , Hh          , Hh          , Mm          , Hh^Fp       , Mm          , Mm          , Mm          , Mm          , Mm          , Mm          , Mm          
Mm          , Mm          , Mm          , Hh          , Hh          , Hh          , Hh          , Rr          , Hh^Fp       , Hh^Fp       , Mm          , Hh          , Hh          , Hh          , Mm          , Mm          , Mm          , Mm          , Mm          , Mm          , Mm          , Mm          
Mm          , Mm          , Mm          , Hh          , Hh          , Hh          , Rr          , Rr          , Hh^Fp       , Gbz         , Mm          , Mm          , Mm          , Hh          , Mm          , Hh^Fp       , Hh^Fp       , Mm          , Mm          , Mm          , Hh^Fp       , Mm          
Mm          , Hh^Fp       , Hh^Fp       , Hh^Fp       , Hh^Fp       , Hh          , Rr          , Hhd         , Hhd         , Hhd         , Mm          , Mm          , Hh^Fp       , Mm          , Mm          , Mm          , Mm          , Hh^Fp       , Hh^Fp       , Hh^Fp       , Mm          , Mm          
Hh^Fp       , Hh^Fp       , Hh^Fp       , Hh^Fp       , Hh^Fp       , Hh^Fp       , Rr          , Hhd         , Hh^Vhh      , Hh^Vhh      , Hhd         , Mm          , Mm          , Mm          , Mm          , Mm          , Mm          , Mm          , Mm          , Mm          , Ms          , Mm          
Hh^Fp       , Hh^Fp       , Hh^Fp       , Hh^Fp       , Hh^Fp       , Hh^Fp       , Hh^Fp       , Rr          , Hhd         , Hhd         , Mm          , Mm          , Mm          , Mm          , Mm          , Mm          , Mm          , Mm          , Mm          , Mm          , Ms          , Ms          
Hh^Fp       , Hh^Fp       , Hh^Fp       , Hh^Fp       , Hh^Fp       , Hh^Fp       , Hh^Fp       , Rr          , Gll^Fmf     , Gll^Fmf     , Hhd         , Mm          , Hh^Fp       , Mm          , Mm          , Mm          , Mm          , Mm          , Mm          , Mm          , Ms          , Ms          
Hh^Fp       , Hh^Fp       , Hh^Fp       , Hh^Fp       , Hh^Fp       , Hhd^Fmf     , Rr          , Rr          , Hhd         , Hhd         , Mm          , Mm          , Mm          , Mm          , Mm          , Mm          , Mm          , Mm          , Mm          , Mm          , Ms          , Ms          
Hh^Fp       , Hh^Fp       , Hh^Fp       , Hh^Fp       , Rr          , Rr          , Gll^Fmf     , Gll^Fmf     , Hhd         , Hhd         , Hhd         , Mm          , Mm          , Mm          , Hh^Fp       , Hh^Fp       , Hh^Fp       , Mm          , Mm          , Mm          , Mm          , Ms          
Hh^Fp       , Hh^Fp       , Hh^Fp       , Hh^Fp       , Rr          , Gll^Fmf     , Gll^Fmf     , Gll^Fmf     , Hhd         , Hhd         , Mm          , Mm          , Hh^Fp       , Ww          , Hh^Fp       , Hh^Fp       , Mm          , Mm          , Mm          , Mm          , Mm          , Ms          
Hh^Fp       , Hh^Fp       , Hh^Fp       , Hh^Fp       , Rr          , Gll^Fmf     , Gll^Fmf     , Gll^Fmf     , Ww          , Ww          , Ww          , Mm          , Mm          , Ww          , Mm          , Mm          , Mm          , Mm          , Mm          , Mm          , Mm          , Mm          
Hh^Fp       , Hh^Fp       , Hh^Fp       , Hh^Fp       , Gg^Fet      , Rr          , Gs          , Gg^Fet      , Ww          , Hh^Fms      , Hh^Fms      , Ww          , Ww          , Ww          , Mm          , Ww          , Mm          , Mm          , Mm          , Mm          , Mm          , Mm          
Hh^Fp       , Hh^Fp       , Hh^Fp       , Hh^Fp       , Hh^Fp       , Rr          , Gs          , Ww          , Hh^Fms      , Hh^Fms      , Hh^Fms      , Hh^Fms      , Ww          , Ww          , Ww          , Ww          , Mm          , Mm          , Mm          , Mm          , Mm          , Mm          
Hh^Fp       , Hh^Fp       , Hh^Fp       , Hh^Fp       , Hh^Fp       , Rr          , Gs          , Ww          , Hh^Fms      , Hh^Fms      , Hh^Fms      , Hh^Fms      , Hh^Fms      , Ww          , Ww          , Ww          , Mm          , Mm          , Hh^Fp       , Mm          , Mm          , Mm          
Rr          , Hh^Fp       , Rr          , Hh^Fp       , Ww          , Rr          , Chr         , Chr         , Rr          , Rr          , Rr          , Hh^Fms      , Hh^Fms      , Ww          , Ww          , Ww          , Hh^Fp       , Hh^Fp       , Hh^Fp       , Hh^Fp       , Mm          , Mm          
Hh          , Rr          , Ww          , Ww^Bw\      , Rr          , Ww^Bw/      , Rr          , Gs          , Gs          , Gs          , Gs          , Rr          , Hh^Fms      , Ww          , Ww          , Ww          , Mm          , Mm          , Mm          , Mm          , Mm          , Mm          
Ww          , Ww          , Ww          , Hh^Fms      , Hh^Fms      , Hh^Fms      , Hh^Fms      , Rr          , Gs          , Gs          , Gs          , Rr          , Rr          , Ww          , Ww          , Ww          , Mm          , Mm          , Mm          , Mm          , Mm          , Mm          
Ww          , Ww          , Ww          , Ww          , Hh^Fms      , Hh^Fms      , Rr          , Rr          , Gs          , 1 Gs        , Gs          , Gs          , Gs          , Chr         , Ww          , Ww          , Mm          , Mm          , Mm          , Mm          , Mm          , Mm          
Ww          , Ww          , Ww          , Ww          , Ww          , Hh^Fms      , Rr          , Gs          , Gs          , Gs          , Gs          , Gs          , Gs          , Ww          , Ww          , Ww          , Ww          , Ww          , Ww          , Ww          , Mm          , Mm          
