border_size=1
usage=map

Gg          , Gg          , Gg          , Gg          , Gg^Fds      , Gg          , Gg^Fds      , Gg          , Gg^Fds      , Gg^Fds      , Gg          , Gg          , Gg          , Gg          , Gg          , Ds          , Gg          , Ds          , Ww          , Ds          , Ds          , Ds          , Ww          , Ww          , Ds          , Ds          , Ds          , Ww          , Ww          , Ww          , Ds          , Gg          , Ds          , Ds          , Gg          , Gg^Fds      , Gg^Fds      , Gg          , Gg          , Gg          
Gg          , Gg          , Gg          , Gg          , Gg          , Gg^Fds      , Gg^Fds      , Gg^Fds      , Gg^Fds      , Gg          , Gg^Fds      , Gg^Fds      , Gg^Fds      , Gg          , Gg          , Gg          , Ds          , Gg          , Gg          , Gg          , Ds          , Ww          , Ww          , Ww          , Ds          , Ds          , Ww          , Gg          , Ww          , Ww          , Ww          , Ds          , Gg^Fds      , Gg          , Gg          , Gg          , Gg^Fds      , Gg^Fds      , Gg          , Gg          
Ww          , Gg          , Gg^Fp       , Gg^Fms      , Gg          , Gg          , Gg^Fds      , Gg^Fds      , Gg^Fds      , Gg^Fds      , Gg^Fms      , Gg^Fms      , Gg^Fds      , Gg^Fds      , Gg^Fds      , Gg          , Gg          , Gg          , Gg          , Gg          , Gg          , Gg          , Ww          , Ww          , Ww          , Ds          , Ds          , Gg          , Gg          , Gg          , Ww          , Ds          , Gg          , Gg^Fds      , Gg          , Gg^Fds      , Gg^Fds      , Gg^Fds      , Gg^Fds      , Gg          
Ww          , Gg          , Gg^Fms      , Gg^Fms      , Gg^Fms      , Gg          , Gg          , Gg^Fds      , Gg^Fds      , Gg^Fms      , Gg^Fms      , Gg^Fms      , Gg^Fms      , Gg^Fds      , Gg^Fds      , Gg          , Gg          , Gg          , Gg          , Gg          , Ww          , Ww          , Ww          , Ww          , Ww          , Gg          , Ds          , Gg          , Gg          , Gg          , Gg          , Ds          , Gg^Fds      , Gg^Fds      , Gg^Fds      , Gg^Fds      , Gg^Fms      , Gg          , Gg          , Gg          
Ww          , Gg          , Gg^Fms      , Gg^Fms      , Gg^Fp       , Gg^Fp       , Gg          , Gg          , Ww          , Gg^Fms      , Gg^Fms      , Gg          , Gg          , Gg^Fms      , Gg          , Gg          , Gg          , Gg          , Gg          , Ww          , Gg          , Gg          , Gg          , Gg          , Ww          , Gg          , Gg          , Gg          , Gg          , Gg          , Gg^Fds      , Gg^Fds      , Gg^Ve       , Gg^Fds      , Gg^Fds      , Gg          , Gg^Fms      , Gg^Fms      , Gg          , Gg          
Ww          , Gg          , Gg          , Hh^Fp       , Hh^Fp       , Hh^Fp       , Gg^Fp       , Gg          , Gg          , Ww          , Gg^Fms      , Gg^Fms      , Gg^Fms      , Gg          , Gg          , Gg          , Gg          , Gg^Vh       , Gg          , Gg          , Gg          , Gg          , Gg          , Gg          , Gg          , Ds          , Gg          , Gg          , Gg          , Gg          , Gg^Fds      , Gg          , Gg^Fds      , Gg^Fms      , Gg^Fds      , Gg^Fms      , Gg          , Gg^Fms      , Gg          , Gg          
Ww          , Ww          , Gg          , Gg          , Gg^Fms      , Gg^Fp       , Gg^Fms      , Gg          , Ww          , Ww          , Gg          , Gg^Fms      , Gg^Fms      , Gg          , Gg          , Gg          , Gg          , Gg          , Gg          , Gg^Fms      , Gg^Fms      , Gg          , Gg          , Gg          , Gg          , Gg          , Ds          , Ds          , Ww          , Ww          , Ww          , Gg^Fds      , Ww          , Gg^Fds      , Gg^Ve       , Gg          , Gg          , Gg          , Gg          , Gg          
Gg          , Ww          , Gg^Fms      , Gg^Fms      , Gg^Fms      , Gg^Fms      , Gg^Fms      , Gg^Fms      , Ww          , Ww          , Gg^Fms      , Gg          , Gg^Fms      , Gg^Fms      , Gg^Fp       , Hh          , Gg^Fms      , Gg          , Gg          , Gg^Vh       , Gg^Fms      , Gg^Fms      , Gg^Vh       , Gg          , Gg          , Gg          , Gg          , Gg          , Gg          , Gg          , Gg          , Ww          , Ce          , Ce          , Gg^Fms      , Gg          , Gg          , Gg          , Gg          , Gg          
Gg          , Gg^Fms      , Kh          , Gg^Fms      , Gg^Fms      , Gg^Fms      , Gg^Fms      , Ww          , Gg^Fms      , Gg^Fms      , Gg^Fms      , Gg^Fms      , Gg^Fms      , Gg          , Gg^Fms      , Gg^Fms      , Hh^Fp       , Gg^Fms      , Gg^Fms      , Gg^Fms      , Gg^Fms      , Gg          , Gg          , Gg          , Gg          , Gg          , Gg          , Gg          , Gg          , Gg          , Ww          , Ww          , Ce          , 1 Ke        , Ce          , Gg          , Gg          , Gg          , Gg          , Gg          
Gg^Fms      , Gg          , Ch          , Ch          , Ch          , Kh          , Gg^Fms      , Ww          , Ww          , Gg          , Gg          , Gg          , Gg          , Gg          , Rp          , Gg^Fms      , Rp          , Hh^Fp       , Hh          , Gg^Fms      , Gg          , Gg          , Gg          , Gg          , Gg          , Gg          , Gg          , Gg          , Gg          , Gg          , Gg          , Gg          , Ss          , Ce          , Ce          , Gg^Fms      , Gg^Fms      , Gg          , Gg          , Gg          
Ch          , Ch          , Gg^Fms      , Gg^Fms      , Rrc         , Ch          , Ww          , Gg^Fms      , Ww          , Gg          , Hh^Fp       , Hh^Fp       , Rp          , Rp          , Gg          , Rp          , Hh^Fp       , Rp          , Hh          , Gg^Fms      , Gg          , Gg          , Gg          , Gg          , Gg          , Gg          , Gs          , Gg          , Gg          , Gg          , Gg          , Gg          , Gg          , Gg          , Gg^Fms      , Gg          , Gg          , Gg^Fms      , Gg^Fms      , Gg          
Gg^Fp       , Rrc         , Rrc         , Rrc         , Rrc         , Ch          , Ch          , Ww          , Ww          , Gg          , Rp          , Rp          , Hh^Fp       , Gg^Fp       , Gg^Fms      , Gg^Fp       , Gg          , Rp          , Hh          , Gg          , Gg          , Gg          , Gg          , Gg          , Gg          , Gs          , Gs          , Gg          , Rr          , Gg          , Gg^Fms      , Gg          , Gg          , Gg          , Gg^Fms      , Gg^Fms      , Gg          , Gg^Fms      , Gg          , Gg          
Rrc         , Rrc         , Rr^Vhc      , Rr^Vhc      , Rrc         , Rrc         , Rrc         , Ch          , Ch          , Kh          , Rp          , Gg          , Hh^Fp       , Hh          , Hh          , Hh          , Gg          , Rp          , Rp          , Gg          , Gg          , Gg          , Rp          , Gg^Fms      , Gg          , Gs          , Rr          , Rr          , Gg          , Rr          , Gg^Fms      , Gg^Fms      , Gg^Fms      , Gg^Fms      , Gg^Fms      , Gg^Fms      , Gg^Fms      , Gg          , Gg          , Gg          
Gg^Fp       , Rr^Vhc      , Rrc         , Rrc         , Rr^Vhc      , Rr^Vhc      , Rrc         , Ch          , Rr          , Rr          , Rp          , Rr          , Kh          , Gg          , Hh          , Gg          , Gg          , Gg^Fms      , Gg          , Rp          , Rp          , Rp          , Gg^Fms      , Rp          , Rp          , Rp          , Gg^Fms      , Gg          , Hh          , Rr          , Rr          , Gg          , Gg^Fms      , Gg          , Gg          , Gg          , Gg^Fms      , Gg          , Gg          , Gg          
Rr^Vhc      , Rrc         , Rrc         , Rrc         , Rr^Vhc      , Rrc         , Ch          , Ch          , Rr          , Rr          , Rr          , Ch          , Qxu         , Hh^Vhh      , Hh          , Hh          , Gg          , Gg^Fms      , Gg^Fms      , Gg^Fms      , Gg^Fms      , Gg^Fms      , Gg          , Gg          , Gg^Fms      , Gg^Fms      , Gg          , Gg          , Hh          , Gg^Vh       , Rp          , Gg^Fms      , Gg^Fms      , Gg          , Gg          , Gg          , Gg          , Gg          , Gg          , Gg          
Hh          , Rr^Vhc      , Rr^Vhc      , Rr^Vhc      , Rrc         , Rrc         , Cud         , Mm          , Cud         , Qxu         , Mm          , Ch          , Qxu         , Hh          , Hh          , Hh          , Hh          , Hh          , Gg^Fms      , Gg^Fms      , Gg^Fms      , Gg^Fms      , Gg^Fms      , Gg          , Gg^Fms      , Gg^Fms      , Gg          , Gg          , Gg          , Hh          , Rp          , Gg^Fms      , Gg          , Gg^Fms      , Gg^Vh       , Gg          , Gg          , Gg          , Hh          , Gg          
Hh          , Hh          , Rr^Vhc      , Hh^Fp       , Rrc         , Rrc         , Cud         , 2 Kh        , Cud         , Qxu         , Mm          , Ch          , Kh          , Hh          , Hh          , Gg          , Hh          , Hh          , Hh          , Gg^Fms      , Gg^Fms      , Gg^Fms      , Gg^Fms      , Gg^Fms      , Gg^Fms      , Gg^Fms      , Gg^Fms      , Gg          , Hh          , Gg^Fms      , Gg          , Rp          , Gg          , Gg          , Gg          , Gg          , Gg          , Gg          , Hh          , Gg          
Hh          , Rr^Vhc      , Rr^Vhc      , Hh^Fp       , Rrc         , Kh          , Qxu         , Cud         , Qxu         , Qxu         , Ch          , Ch          , Qxu         , Mm          , Hh          , Hh          , Hh          , Hh          , Hh          , Hh          , Gg          , Gg          , Gg^Fms      , Gg^Fms      , Gg^Fms      , Gg^Fms      , Gg^Fms      , Gg          , Gg          , Gg^Fms      , Hh          , Rp          , Rp          , Hh          , Gg          , Gg          , Gg          , Gg          , Hh          , Hh          
Mm          , Rrc         , Rrc         , Rrc         , Ch          , Ch          , Ch          , Qxu         , Ch          , Ch          , Qxu         , Qxu         , Hh          , Hh          , Hh          , Hh          , Hh          , Hh          , Hh          , Hh          , Hh          , Gg^Fms      , Gg^Fms      , Gg          , Gg^Fms      , Gg^Fms      , Gg^Fms      , Gg          , Gg          , Gg          , Gg          , Gg          , Gg          , Rp          , Ce          , Gs          , Ce          , Gg          , Gg          , Gg          
Mm          , Hh^Vhh      , Hh^Vhh      , Ch          , Qxu         , Qxu         , Ww          , Ch          , Gg          , Kh          , Gg          , Hh          , Gg          , Gg          , Hh          , Hh          , Hh          , Hh          , Hh          , Hh          , Hh          , Hh          , Gg          , Gg          , Gg^Fms      , Gg^Fms      , Ww          , Ww          , Ww          , Ww          , Gg          , Gg          , Hh          , Gg          , Ce          , 3 Ke        , Ce          , Gg          , Gg          , Hh          
Hh^Vhh      , Mm          , Mm          , Ch          , Qxu         , Gg          , Ww          , Ww          , Ww          , Gg          , Gg          , Hh          , Gg          , Gg          , Gg          , Hh          , Hh          , Hh          , Hh          , Hh          , Hh          , Hh          , Hh          , Gg          , Ww          , Ww          , Ww          , Gg          , Gg          , Ww          , Gg          , Gg          , Hh          , Gg          , Hh          , Hh          , Gg^Vh       , Ce          , Hh          , Hh          
Ch          , Mm          , Ch          , Ch          , Kh          , Gg          , Gg          , Ww          , Ww          , Ww          , Gg          , Gg          , Gg          , Gg          , Gg^Fms      , Gg          , Hh          , Gg^Fms      , Hh^Fp       , Gg^Fp       , Hh^Fp       , Hh          , Hh          , Hh          , Gg          , Ww          , Gg          , Gg^Fms      , Gg^Fms      , Gg          , Gg          , Hh          , Hh          , Hh          , Hh          , Gg          , Gg          , Ce          , Hh          , Hh          
Qxu         , Ch          , Qxu         , Qxu         , Hh          , Hh          , Hh          , Gg          , Ww          , Ww          , Ww          , Ww          , Gg          , Gg          , Gg^Fms      , Gg          , Gg          , Ww          , Ww          , Gg^Fms      , Gg^Fp       , Hh          , Hh          , Hh          , Hh^Fp       , Gg^Fp       , Gg          , Hh^Fp       , Hh^Fp       , Hh^Fp       , Gg          , Hh          , Hh          , Hh          , Hh          , Hh          , Hh^Vhh      , Hh          , Hh          , Hh          
Mm          , Qxu         , Mm          , Mm          , Hh          , Hh          , Hh          , Gg          , Ww          , Ww          , Ww          , Ww          , Gg          , Gg          , Gg^Fms      , Gg^Fms      , Ww          , Ww          , Ww          , Ww          , Gg^Fp       , Hh          , Hh          , Hh          , Hh^Fp       , Gg^Fp       , Gg^Fms      , Gg^Fp       , Hh^Fp       , Hh^Vhh      , Gg          , Hh          , Hh          , Hh          , Hh          , Hh          , Hh          , Hh          , Hh          , Hh          
Mm^Xm       , Mm          , Mm          , Mm          , Mm          , Mm          , Hh          , Hh          , Gg          , Ww          , Ww          , Gg          , Gg          , Gg^Fms      , Gg^Fms      , Ww          , Gg^Fms      , Gg^Fms      , Gg^Fms      , Gg^Fms      , Gg^Fms      , Gg^Fms      , Hh          , Gg          , Hh^Fp       , Hh^Fp       , Gg^Fp       , Hh^Fp       , Hh^Fp       , Hh^Fp       , Hh^Fp       , Hh          , Hh          , Hh          , Hh          , Hh          , Mm          , Hh          , Mm          , Hh          
